Sorting_Barcode	GX19	Target	geneID
TTTGGTCGCTCACAGTCTCACGCT	GGATGaATCAGCTTCTGGC	TTTTTGGATGAATCAGCTTCTGGCTGGTGT	GPR98_p.E3265G
TTTGATCTATCTATCATCTACACA	ACTTaGGTGCTAGTCCTAT	TTTTGACTTAGGTGCTAGTCCTATGGGAGT	EP300_p.001
TTTGCTACTACTCTCACACGATAC	ACTTaGGTGCTAGTCCTAT	TTTTGACTTAGGTGCTAGTCCTATGGGAGT	EP300_p.001
TTTGTGATCACGCACATCTGCTCA	TCACGaGGATGACACCTTG	TTTTATCACGAGGATGACACCTTGGGGAAC	FCRL3_p.E513G
TTTGCTCACTACACTCACTACGTA	TAGGaAAAACATCAGAGAG	TTTTATAGGAAAAACATCAGAGAGAGGCTC	TCF12_p.G105G
TTTGTGCTACACACATGCGTACAT	TAGGaAAAACATCAGAGAG	TTTTATAGGAAAAACATCAGAGAGAGGCTC	TCF12_p.G105G
TTTGCAGTCACTGTCTCACATCAG	AACAGaTAGTGAAAGTACA	TTTGTAACAGATAGTGAAAGTACAAGGTAA	NR2C1_p.D226G
TTTGATCACTACTACGCACTCACA	AACAGaTAGTGAAAGTACA	TTTGTAACAGATAGTGAAAGTACAAGGTAA	NR2C1_p.D226G
TTTGACTCACACTCACTGTCTATG	TCTaTGCCCTGCTGAGCCA	TTTGCTCTATGCCCTGCTGAGCCATGGGGA	PATL2_p.Y462C
TTTGATGCACATCTAGTCACGTCT	TGCTaGAATCCCTGCTTGG	TTTGATGCTAGAATCCCTGCTTGGTGGAAA	DNAH5_p.R4439G
TTTGCTCTGACACTATCACACACG	CCAGTaCTCCGTGGAGGGT	TTTCACCAGTACTCCGTGGAGGGTGGGAAG	S100A14_p.Y32C
TTTGTACAGTCACTCACACAGTCA	AATCTaTTAATGGGTAAGT	TTTCAAATCTATTAATGGGTAAGTTGGCAG	GGH_p.I90V
TTTGCTCACGCTCGCTACATCATC	AGGaTCACATGCGTGAAGC	TTTAAAGGATCACATGCGTGAAGCAGGTGA	SRSF1_p.D139G
TTTGACTCACACATATCAGTCTAC	AGGaTCACATGCGTGAAGC	TTTAAAGGATCACATGCGTGAAGCAGGTGA	SRSF1_p.D139G
TTTGTCACTACTCACTATGTCATA	GCAGaGGAACCCGGCAACC	TTGTTGCAGAGGAACCCGGCAACCTGGAGG	SLC16A8_p.E471G
TTTGCTCATATACATCATCGCTAT	GTGGaCCGGTCCCAGAAGC	TTGTGGTGGACCGGTCCCAGAAGCTGGAGC	TMC3_p.D342G
TTTGTATACTCAGCATCATCAGAC	GCCaGGGGCTTAATAGCCC	TTGTGGCCAGGGGCTTAATAGCCCGGGGAG	DCXR_p.R120G
TTTGTCTGTCACTCGCTCTATCGC	AGCTaCTACAGGAGGGAGA	TTGTAAGCTACTACAGGAGGGAGAAGGGGA	TIRAP_p.001
TTTGGCAGCTACACTCTCTCTCTG	GCCCCaCTGGCTTCAAGGT	TTGGTGCCCCACTGGCTTCAAGGTTGGCAT	TUBA1C_p.T349A
TTTGGTACACACATACACTCTCGC	GCCCCaCTGGCTTCAAGGT	TTGGTGCCCCACTGGCTTCAAGGTTGGCAT	TUBA1C_p.T349A
TTTGCGCTCACTACACAGCACGCT	ACAaGGGGAAAACGGCAGA	TTGGCACAAGGGGAAAACGGCAGAAGGGAG	CEACAM4_p.K69R
TTTGCAGACTCACACTCGCACATA	ACTCaAGGATGCCCAGGCT	TTGGAACTCAAGGATGCCCAGGCTGGGAAG	TP53_p.K351E
TTTGAGTCTATGTCATCACACATC	ACTCaAGGATGCCCAGGCT	TTGGAACTCAAGGATGCCCAGGCTGGGAAG	TP53_p.K351E
TTTGACATGCTCGTCTACATCGTC	CCTaTGTTGGGCGCCGAGG	TTGCTCCTATGTTGGGCGCCGAGGAGGAGG	TLL2_p.Y217C
TTTGTCACTCACTCACTGTCTCAT	CTGAaCGTGGTGGACAACC	TTGCCCTGAACGTGGTGGACAACCTGGTAG	C18ORF8_p.N269S
TTTGACTCTCACACTCATGCATCA	ACCaCGGAGGCGCTGAGCA	TTGCCACCACGGAGGCGCTGAGCATGGCCC	MX2_p.T273A
TTTGGTATCTCACGCACATCTCTA	GTGGaCAAGAAGTTAGAAG	TTGATGTGGACAAGAAGTTAGAAGAGGGCC	KIF20A_p.D731G
TTTGTCTCATCATGTCATCTCTAT	ATCaTCCCTGGTGACACAC	TTGATATCATCCCTGGTGACACACTGGGTG	TNRC6B_p.I1330V
TTTGTCATATACTCACACGTCTAC	GTGCaGCGGTACGAGAACT	TTGAGGTGCAGCGGTACGAGAACTCGGCCC	WBSCR17_p.Q286R
TTTGATCTCATCACGCACGTCTAT	GGCaGCCGGCAGGCGCTGA	TTGAGGGCAGCCGGCAGGCGCTGAAGGTCA	PREX1_p.S1433G
TTTGACTGTCACACACATCTCAGT	GATGaAGAGGAGGAGGAGG	TTGAGGATGAAGAGGAGGAGGAGGAGGAAG	PDIA4_p.E41G
TTTGCACTCATCTGCGTCATATCT	GATGaAGAGGAGGAGGAGG	TTGAGGATGAAGAGGAGGAGGAGGAGGAAG	PDIA4_p.E41G
TTTGACGCACTCACAGCACTACAG	AACTaTGTGGCAGATATCG	TTGAGAACTATGTGGCAGATATCGAGGTGG	RHOA_p.Y42C
TTTGAGCACACATCTCGTATCTCG	AACTaTGTGGCAGATATCG	TTGAGAACTATGTGGCAGATATCGAGGTGG	RHOA_p.Y42C
TTTGTGTCACAGTCTATCATCATA	GAaCGAGATGGAGAATGAG	TTGAAGAACGAGATGGAGAATGAGCGGTGG	CGNL1_p.N937S
TTTGCTGTCACACACAGCACAGTA	CGCaGCACTCTGACGGGCG	TTGAACGCAGCACTCTGACGGGCGTGGATC	LRP2_p.S2578G
TTTGGTACATACTACACTCGATAC	CTGCaGGAATCAGAAGGTC	TTCTTCTGCAGGAATCAGAAGGTCAGGGCT	CBL_p.001
TTTGCACATACTACTCATACAGCT	AATCaGCGTGCTCAGGGCA	TTCTTAATCAGCGTGCTCAGGGCAAGGAGC	CEP85L_p.Q735R
TTTGCTATCATGCATCAGTCTCAG	CTGGGaGGTTGGGGTCTCT	TTCTGCTGGGAGGTTGGGGTCTCTGGGAGC	MUC20_p.E17G
TTTGCGTATCACTACATCGTCATA	CTGGGaGGTTGGGGTCTCT	TTCTGCTGGGAGGTTGGGGTCTCTGGGAGC	MUC20_p.E17G
TTTGTCTGCTCTGTCACGTCGTCT	AACGTaTGGTGAAAGAGAA	TTCTGAACGTATGGTGAAAGAGAAGGGTTC	ZNF518B_p.M385V
TTTGATCTAGTACATCATCTACTA	ATCaTGTCTGGTGGCTCCG	TTCGGATCATGTCTGGTGGCTCCGCGGATT	EIF4A2_p.M1V
TTTGCTCATACTCACAGCTCACTA	CGTTGGACTATGGCGGGTC	TTCGCCGTTGGACTATGGCGGGTCAGGAGC	NT_nontargetX
TTTGTCTCGATCACACTCACACGC	GTCaCCACGCAGCGAGCCC	TTCGAGTCACCACGCAGCGAGCCCTGGGCC	PRRT3_p.T423A
TTTGCGCACACGTCACTCTCATAC	GTCaCCACGCAGCGAGCCC	TTCGAGTCACCACGCAGCGAGCCCTGGGCC	PRRT3_p.T423A
TTTGGCTCACACTGTACACACATA	GCTCTaGCTGTGGCAAGCG	TTCCTGCTCTAGCTGTGGCAAGCGGGGCTG	KRTAP5-9_p.S56G
TTTGACTACACTGATACTCTCTCA	AGAGaCAGAGAAGTCGCGC	TTCCGAGAGACAGAGAAGTCGCGCTGGTCA	ALKBH7_p.T76A
TTTGACACTACATATATATCTACT	TGTaTAATAACAACTTGAA	TTCCCTGTATAATAACAACTTGAACGGAAT	SMARCA2_p.Y739C
TTTGGCATCACATCTCTCTAGATA	CTAGaAGGCGCATCTGATG	TTCCACTAGAAGGCGCATCTGATGCGGATG	PCDHA10_p.E154G
TTTGCTGACACTACATCATCGCAT	CTAGaAGGCGCATCTGATG	TTCCACTAGAAGGCGCATCTGATGCGGATG	PCDHA10_p.E154G
TTTGCGTCTATATCTACTCACTCA	GCGCCaTCTGTGTGAGCCT	TTCATGCGCCATCTGTGTGAGCCTGGGGCA	CHD3_p.H1462R
TTTGGCACTACTACATCTCGCTCT	GCGCCaTCTGTGTGAGCCT	TTCATGCGCCATCTGTGTGAGCCTGGGGCA	CHD3_p.H1462R
TTTGCTCTCACTCTCACTACTCGC	TCCTaTGAAGTCAATATCG	TTCAGTCCTATGAAGTCAATATCGAGGCGA	PCDHB8_p.Y316C
TTTGTATATATCAGCTCAGTCACT	TCCTaTGAAGTCAATATCG	TTCAGTCCTATGAAGTCAATATCGAGGCGA	PCDHB8_p.Y316C
TTTGATACATCTAGTCACTGCGTC	GCCACaATGGAGGCTGTGG	TTCAGGCCACAATGGAGGCTGTGGGGGTGA	ZNF398_p.N591D
TTTGAGTATATCATCTAGCTACGC	GCCACaATGGAGGCTGTGG	TTCAGGCCACAATGGAGGCTGTGGGGGTGA	ZNF398_p.N591D
TTTGGATACTACAGCTATCACGCG	CATGaGGTCATAAAGAATG	TTCAGCATGAGGTCATAAAGAATGAGGTGA	SPAG17_p.E1772G
TTTGGCTCACTATGCACTCTAGTC	ACCATaAAGCACCTAATGG	TTCAGACCATAAAGCACCTAATGGAGGCAG	SLC12A6_p.I763M
TTTGTGCGCTCACATCACTCACGT	ACCATaAAGCACCTAATGG	TTCAGACCATAAAGCACCTAATGGAGGCAG	SLC12A6_p.I763M
TTTGCTACTGCACTACACGCTACA	AGTGAaGCTGCACTGGTGG	TTCACAGTGAAGCTGCACTGGTGGAGGTTC	RNF121_p.K98R
TTTGCGACTCACTCAGCTACGCTC	GTaGTGGCAGAGCAGAACA	TTCAAGTAGTGGCAGAGCAGAACAAGGAAT	CMYA5_p.S348G
TTTGTCTGCTATCGCACACATCGC	AGCGaGAAGCGGTTGCAGG	TTCAAAGCGAGAAGCGGTTGCAGGAGGTGA	NCKAP5_p.E88G
TTTGTCTCACACACACACTATAGT	GTaGGTTCGAGACTATAAG	TTATTGTAGGTTCGAGACTATAAGAGGCTT	SUPV3L1_p.001
TTTGCATAGTCACACTCACAGTAC	GTaGGTTCGAGACTATAAG	TTATTGTAGGTTCGAGACTATAAGAGGCTT	SUPV3L1_p.001
TTTGTACTCGATCTACACTACTCT	ATGaCCAAACAGAAGATAT	TTATTATGACCAAACAGAAGATATTGGAAG	RXFP2_p.D579G
TTTGGTATGATCTACATCGTCATA	GGGTaCCTTTCAACAGATG	TTACAGGGTACCTTTCAACAGATGTGGATT	ACTL6A_p.T405A
TTTGACGCTCTACTCGCACTCACT	GGGTaCCTTTCAACAGATG	TTACAGGGTACCTTTCAACAGATGTGGATT	ACTL6A_p.T405A
TTTGTGTCATCATCACTACAGATA	CCGaGGACTGGGCTGGTGG	TTAACCCGAGGACTGGGCTGGTGGTGGCCC	TMEM215_p.R9G
TTTGCTACTGTCTACTCATCGTAC	GAGaTCACACTGGAAAATA	TTAAAGAGATCACACTGGAAAATAAGGTAC	ATG3_p.I126V
TTTGGTGCATCTACTCTCTATCAT	GTGGaGTCCTCGCTGGACA	TGTTTGTGGAGTCCTCGCTGGACAAGGTGG	TRADD_p.E20G
TTTGTATATCATCTATCTACATCA	ACAaCCTTTTCTTCCTGCA	TGTTGACAACCTTTTCTTCCTGCAGGGTAT	DENND4B_p.N489S
TTTGCTCTGCTATCACAGTACTAC	CGCGaGGTTGAGGAACTGA	TGTTCCGCGAGGTTGAGGAACTGATGGAGG	DKK3_p.E53G
TTTGACTGCACACACATCTCGCAG	CCTGGaCAAACCAGAGGAG	TGTTACCTGGACAAACCAGAGGAGTGGCAT	ABHD14B_p.D193G
TTTGGCTCAGCTCTCTCACACACT	CCTGGaCAAACCAGAGGAG	TGTTACCTGGACAAACCAGAGGAGTGGCAT	ABHD14B_p.D193G
TTTGTCGTAGTCTCACTCATCACA	GGCCaGAGCTCCCAGCCCC	TGTGTGGCCAGAGCTCCCAGCCCCTGGTGA	TMEM176B_p.Q235R
TTTGCACATGATCTACTACACGTC	CTGCCaCTGACCCAGACTT	TGTGTCTGCCACTGACCCAGACTTGGGTAC	FAT4_p.T714A
TTTGTACTCATATCATATCGTCGT	CGCCaGTGGCTGCGTCCAG	TGTGTCGCCAGTGGCTGCGTCCAGAGGTAC	MZF1_p.Q71R
TTTGGTAGTCACATCTATCATCGA	CAaTTAGTTGAAGTAATGA	TGTGTCAATTAGTTGAAGTAATGATGGCAA	NF1_p.Q1017Q
TTTGTATACATGCTCACTAGCTCA	CAaTTAGTTGAAGTAATGA	TGTGTCAATTAGTTGAAGTAATGATGGCAA	NF1_p.Q1017Q
TTTGGCACACACTACTCATCATAG	GGGCTaTGGCTCTGGCTGT	TGTGGGGGCTATGGCTCTGGCTGTGGGGGC	KRTAP5-10_p.Y31C
TTTGCACTCACTAGTCTAGCACAT	GAAAAaGTGTGGATTTACC	TGTGGGAAAAAGTGTGGATTTACCTGGAGA	SWT1_p.S357G
TTTGTGCTCTACTCTCATATCTAC	GAAAAaGTGTGGATTTACC	TGTGGGAAAAAGTGTGGATTTACCTGGAGA	SWT1_p.S357G
TTTGATCTCTCACACTCTAGCGTA	CTGGaGGTCCCAGATTCAG	TGTGGCTGGAGGTCCCAGATTCAGCGGCCC	C6ORF27_p.E791G
TTTGCTATCTCATATCTCATCAGC	CGGGGaTGGAAGTGTTGGC	TGTGGCGGGGATGGAAGTGTTGGCTGGGTC	DGKD_p.D336G
TTTGCACATCGTCTACAGCTCAGT	ATAaTGCCCTGAGGGCAGT	TGTGGATAATGCCCTGAGGGCAGTTGGAGA	TLN1_p.N1211S
TTTGGATCTATCACGATCATCACA	ATAaTGCCCTGAGGGCAGT	TGTGGATAATGCCCTGAGGGCAGTTGGAGA	TLN1_p.N1211S
TTTGTATCGTATATCACTCTCATA	AATaCCTGTACAGCCAGGA	TGTGGAATACCTGTACAGCCAGGATGGCAG	ACACA_p.Y367C
TTTGATATATCAGTCACACACTCG	TGTaCAATGTGAGTAGAGC	TGTGCTGTACAATGTGAGTAGAGCTGGTGG	CACNA1E_p.Y316C
TTTGTCACACTACTACACTATAGA	TGTaCAATGTGAGTAGAGC	TGTGCTGTACAATGTGAGTAGAGCTGGTGG	CACNA1E_p.Y316C
TTTGCACTGCTCTGCTACGCACGC	AGaCTCCAAGGTGAGGGTT	TGTGCAGACTCCAAGGTGAGGGTTAGGATT	ABHD5_p.T256A
TTTGTCTGTATACACATCACTCTG	TTGaGTCCTTCAACCTGGA	TGTCTTTGAGTCCTTCAACCTGGACGGGCT	RYR1_p.E768G
TTTGACTACATCTCACACTCTGTA	GATGaCTGGGCACGGACGG	TGTCTGATGACTGGGCACGGACGGCGGCAC	PITPNM1_p.D175G
TTTGACTCATCTCACTACATACAG	AGGATaTTCCTCAGGGAGC	TGTCTAGGATATTCCTCAGGGAGCTGGAAA	MCF2L_p.I663M
TTTGCATGCACTCTCTCAGCTCGC	AGAaCGGTGCTTCTATGGC	TGTCGAGAACGGTGCTTCTATGGCAGGATA	CCDC126_p.N72S
TTTGTGCTCTCATCAGATACATAG	ACaGGGCGGGTTCCCGCAG	TGTCCACAGGGCGGGTTCCCGCAGTGGCAG	FAM59B_p.001
TTTGCGTCACTATCACACGTATAT	AACaTGCAGCGCTACGACC	TGTCCAACATGCAGCGCTACGACCTGGCCT	C6ORF174_p.M733V
TTTGCAGCTCTACGTCTACATCAC	AACaTGCAGCGCTACGACC	TGTCCAACATGCAGCGCTACGACCTGGCCT	C6ORF174_p.M733V
TTTGAGTCACATCATCTGCACTAT	TGGaCCTAGAGCCTCAGGT	TGTCATGGACCTAGAGCCTCAGGTGGGTCC	MPP4_p.D524G
TTTGAGATCAGTACATCTACACAC	TCCaGGGGCCCTTGCACAC	TGTCATCCAGGGGCCCTTGCACACTGGAGA	C20ORF74_p.R166G
TTTGTCGTCATCTATCTGCACACA	TCaTCACTCCAGAAAGCTT	TGTAGTCATCACTCCAGAAAGCTTTGGAAG	IL7R_p.I356V
TTTGATGTCTATACTCACTACGTC	TCaTCACTCCAGAAAGCTT	TGTAGTCATCACTCCAGAAAGCTTTGGAAG	IL7R_p.I356V
TTTGGTCACTCACTATAGTCACAC	GGGGAaCGTGAAGGGGAAA	TGTAGGGGGAACGTGAAGGGGAAACGGCCC	PI16_p.N170S
TTTGACACAGCTACACTATCATCG	GGGGAaCGTGAAGGGGAAA	TGTAGGGGGAACGTGAAGGGGAAACGGCCC	PI16_p.N170S
TTTGCTCGTCACTACGCACTCTCG	CTGCaGTACAAGGCTGACC	TGTAGCTGCAGTACAAGGCTGACCTGGCAT	NRAP_p.Q682R
TTTGAGCACATCGCACACAGCTCG	CTCaGGGGAGCCACCACCC	TGGTTCTCAGGGGAGCCACCACCCAGGGGC	CCT8L2_p.R378G
TTTGCGCTCTCACATCTCATATGT	GGGGaGCTTCAGGCTGCTG	TGGTGGGGGAGCTTCAGGCTGCTGAGGATC	SMPD1_p.E411G
TTTGGTACTCTAGCATCGTACTAC	CAGAGaGGGGGAATCTGAA	TGGTGCAGAGAGGGGGAATCTGAATGGTGA	RELN_p.R1825G
TTTGTCACATCTCGTCTATCACAC	CAGAGaGGGGGAATCTGAA	TGGTGCAGAGAGGGGGAATCTGAATGGTGA	RELN_p.R1825G
TTTGGCATCTCAGTCAGCACTATA	ACTaTGACCCAGAAGAACA	TGGTGACTATGACCCAGAAGAACATGGCAG	EPB41L2_p.Y348C
TTTGACATCACTCTATCACTGTCA	GCCCaGGCCCCGTGGGTGC	TGGGTGCCCAGGCCCCGTGGGTGCCGGAAG	MAP3K11_p.Q838R
TTTGCACATCTCATCACTACTACA	GGTaCCTGGACTACCTGGA	TGGGGGGTACCTGGACTACCTGGAAGGCAT	SLC24A6_p.Y80C
TTTGATCATCTCTCTCTCTACAGC	GCCGaCCGACATTGACCAC	TGGGGGCCGACCGACATTGACCACTGGAAG	C7ORF29_p.T94A
TTTGACTATCTGTCTACTCTATCG	GACTaCATAGCTGCTTTTG	TGGGGGACTACATAGCTGCTTTTGAGGCCA	KANK1_p.Y1139C
TTTGTCATGATATCATCTACGTCA	ATGAaGGCCTATGATGGCT	TGGGGATGAAGGCCTATGATGGCTTGGTTA	KIAA1486_p.K29R
TTTGAGACTCATCTGTCACACACA	ATGAaGGCCTATGATGGCT	TGGGGATGAAGGCCTATGATGGCTTGGTTA	KIAA1486_p.K29R
TTTGATACATACTACACTCGCTCA	ATCCaGGACCCCGAGCGGC	TGGGGATCCAGGACCCCGAGCGGCAGGAGT	ASB6_p.Q28R
TTTGACATACACGCATATCATATC	ATCCaGGACCCCGAGCGGC	TGGGGATCCAGGACCCCGAGCGGCAGGAGT	ASB6_p.Q28R
TTTGATGCATCATCTATCATCAGT	TTCaTGAGGTGAGAGGCAG	TGGGCTTCATGAGGTGAGAGGCAGCGGGGA	TMEM104_p.M55V
TTTGCACTCATGCATACACACAGC	TCCCaAAATGAGGTGAAGG	TGGGCTCCCAAAATGAGGTGAAGGAGGAAG	NEUROD4_p.Q28R
TTTGCATACTACACGCGTACTCAC	AGAAaGAAAAATGGTGAAG	TGGGCAGAAAGAAAAATGGTGAAGAGGTCA	BLNK_p.K412R
TTTGTGCTCACACATATCTACACG	AGGaGGCTGCTGCTGAGGT	TGGGAAGGAGGCTGCTGCTGAGGTCGGTGC	IL6R_p.R80G
TTTGACTCACTGTCTCACGTCTAT	GTCGGaCCCACCTGGAGCC	TGGCTGTCGGACCCACCTGGAGCCGGGACC	THAP4_p.D23G
TTTGCGCTACATCTCACTGCACTA	GCCaGCGACATAGCAGCCC	TGGCTGCCAGCGACATAGCAGCCCTGGGCA	LLGL1_p.S148G
TTTGGCTCTCTCTAGATCATATCA	GAGaGTAGGCTCCGGGCCC	TGGCTGAGAGTAGGCTCCGGGCCCCGGACC	DBF4B_p.S20G
TTTGGTCATCTCTCACATGCGTAC	CCGCaGATACCTGGAGAAC	TGGCTCCGCAGATACCTGGAGAACGGGAAG	HLA-C_p.R194G
TTTGTACTACTATCAGCACGCATA	GCCaGCGCCCTGAACCGGG	TGGCGGCCAGCGCCCTGAACCGGGCGGACT	TP53I3_p.S32G
TTTGTCGCACTACACATCGTCAGA	CTTAACCTATCCGCCAGTA	TGGCGCTTAACCTATCCGCCAGTAAGGCCT	NT_nontargetX
TTTGTGACACTCATCATCACAGAC	AGGACaCCGTGGTGCATGA	TGGCGAGGACACCGTGGTGCATGAGGGCCA	IP6K2_p.T396A
TTTGAGCTATCAGCTCTCACACAG	AGGACaCCGTGGTGCATGA	TGGCGAGGACACCGTGGTGCATGAGGGCCA	IP6K2_p.T396A
TTTGTAGACACTCTCACGCTCGTA	TTTGaTGTGTCCTGGTTTG	TGGCCTTTGATGTGTCCTGGTTTGCGGTGC	PTGFRN_p.D728G
TTTGACGTATATATCTATCATCTG	TGGTaCCAGGTGAGCCCGC	TGGCCTGGTACCAGGTGAGCCCGCTGGCCG	TSPO_p.V33V
TTTGTGTCTGCTCTCACTCACGCG	GCaCTGGCTCCCGGCGCTC	TGGCCGCACTGGCTCCCGGCGCTCCGGCTA	ATP8B2_p.T1155A
TTTGCTCATCACATCATCGTACTA	GAGGaCATCGATAAAGGCG	TGGCCGAGGACATCGATAAAGGCGAGGTGT	EEF2_p.D616G
TTTGGCATATACATATATCTATAG	GAGGaCATCGATAAAGGCG	TGGCCGAGGACATCGATAAAGGCGAGGTGT	EEF2_p.D616G
TTTGAGCTCTCACACTCATATGTC	GACaGCATCCCCGAAGTCC	TGGCCGACAGCATCCCCGAAGTCCTGGCGG	PCDHGA11_p.S668G
TTTGTGTCATCAGCATCGCACTCA	CAGaGGACCCTGTACCGAG	TGGCCCAGAGGACCCTGTACCGAGAGGTGA	ZNF550_p.R25G
TTTGCACGCTACTACACTCACTCT	ATGCCaATGGCCAGCGCAT	TGGCCATGCCAATGGCCAGCGCATTGGCCG	PCOLCE2_p.N99D
TTTGTCTAGTACTCATCAGCACGC	AGGGCaGAGCTAAGATGTG	TGGCCAGGGCAGAGCTAAGATGTGTGGGCT	IMP5_p.R531G
TTTGCTGACACTCTGCTCTCTCTA	GCTGGaCCTCAGTTCTCGC	TGGCAGCTGGACCTCAGTTCTCGCTGGCAG	KIAA1404_p.D926G
TTTGTCTCTCTCACACACTCTCAT	GCCTGaCAATGAGCAGCAG	TGGCAGCCTGACAATGAGCAGCAGTGGCAG	EDC4_p.T666A
TTTGGCTCTACATGCGTACTCATA	GCCTGaCAATGAGCAGCAG	TGGCAGCCTGACAATGAGCAGCAGTGGCAG	EDC4_p.T666A
TTTGATGTCATCACTCACAGATAT	CAGGaTGAAGCTGTATGGC	TGGCACAGGATGAAGCTGTATGGCTGGAGC	MPG_p.D239G
TTTGGTCACTCTATCGTCTGCTCA	ATGCaGGCTATGCTGCACT	TGGCAATGCAGGCTATGCTGCACTGGGCAA	NLRP13_p.Q247R
TTTGGTCTGCTCTATCACATCTGC	ACCACaATGAAGGAAGCAC	TGGCAACCACAATGAAGGAAGCACTGGGAG	TNRC6C_p.N407D
TTTGCATGTCTACTCGCTACTATC	ACCACaATGAAGGAAGCAC	TGGCAACCACAATGAAGGAAGCACTGGGAG	TNRC6C_p.N407D
TTTGAGAGACACTCACATCACTCG	GTGGTaAAAAGAATAAGCC	TGGATGTGGTAAAAAGAATAAGCCAGGTGT	TMPRSS11B_p.K393E
TTTGGTCACACAGCATATACTCGT	GGTaCTTTGCTGGTGGGTG	TGGATGGTACTTTGCTGGTGGGTGAGGATG	CHD8_p.T2045A
TTTGTGCTCTACTCTAGTATATAT	GGTaCTTTGCTGGTGGGTG	TGGATGGTACTTTGCTGGTGGGTGAGGATG	CHD8_p.T2045A
TTTGTACTATCACATCACTATAGT	TAATaTCTGTGGAGCCTCC	TGGAGTAATATCTGTGGAGCCTCCTGGCAT	FAT_p.I1380M
TTTGAGCTCGCTCTCACACTACAC	GAGaCCCCATTCCCCCACG	TGGAGGAGACCCCATTCCCCCACGAGGGCC	ZNF469_p.T688A
TTTGTCATATCACATGTCTACTCA	CTCCaCAAAGGCGAGGTGG	TGGAGCTCCACAAAGGCGAGGTGGTGGATG	GPHN_p.H756R
TTTGCATGCATCTACATCTGCTCA	CTCCaCAAAGGCGAGGTGG	TGGAGCTCCACAAAGGCGAGGTGGTGGATG	GPHN_p.H756R
TTTGGCAGTCTACATACATCTGTC	CTaCTGGTGCAAATAGCTT	TGGAGCTACTGGTGCAAATAGCTTAGGCAA	MEF2A_p.T240A
TTTGCGCTCACATACTACACAGCT	GCTCAaTGGCTCTGCAGCT	TGGACGCTCAATGGCTCTGCAGCTCGGACA	SELE_p.N527S
TTTGCATCTCTCACGTATATATCA	GCTaTGAGAGGGCGTCCCA	TGGACGCTATGAGAGGGCGTCCCAGGGCCC	SLC15A3_p.Y563C
TTTGGCACAGCACACACTGTCGTC	CAGaGTGAGCTGGGCTACC	TGGACCAGAGTGAGCTGGGCTACCTGGCCA	LRRN2_p.S87G
TTTGACTACACACAGCTCTATCGT	AGATaCTTCTATAACCAGG	TGGACAGATACTTCTATAACCAGGAGGAGT	HLA-DRB1_p.Y59C
TTTGCTCTCTATCGTCTACATCTA	AACaTGATCTGCCTCCTGC	TGGACAACATGATCTGCCTCCTGCAGGGGC	ITPKC_p.M673V
TTTGTCTATACTACTCACTGTATC	CAaTCTGAGTGCGGTGGAG	TGGAACAATCTGAGTGCGGTGGAGCGGGCC	ADORA1_p.N148S
TTTGAGCTCAGTCAGTCTATATAC	AAATaTGAAAACCTGGGTT	TGGAAAAATATGAAAACCTGGGTTTGGTTG	CDKL2_p.Y4C
TTTGAGTCAGCACACACTACGAGT	TGGCaGAAGTTGGTTGACA	TGCTTTGGCAGAAGTTGGTTGACAAGGCTC	DALRD3_p.Q132R
TTTGACTATATCACACTCAGTCTA	ATAGAaTGACAATAGAGAA	TGCTTATAGAATGACAATAGAGAACGGCAG	PSEN1_p.N30S
TTTGTGCTCTACACATGCACACAT	ATAGAaTGACAATAGAGAA	TGCTTATAGAATGACAATAGAGAACGGCAG	PSEN1_p.N30S
TTTGACACTACTCTACATGCGCGT	GCCAaGCTGCAGCGGACTC	TGCTGGCCAAGCTGCAGCGGACTCGGGCCA	ADCY6_p.K568R
TTTGAGCATCGTCATATCTCTATA	TGGaTCGAAGTTTTCACAT	TGCTCTGGATCGAAGTTTTCACATTGGCTG	TRIP6_p.D422G
TTTGCACTACATACATCAGTCAGC	TGGaCCTCCCTCCTGCTCC	TGCTCTGGACCTCCCTCCTGCTCCTGGCCA	CPN2_p.T10A
TTTGACATACATCTCACGCACTAG	GATaGACACCAAGAGCACA	TGCTAGATAGACACCAAGAGCACAAGGTAA	SPTAN1_p.R402G
TTTGACACTATCACACATGCGACT	GATaGACACCAAGAGCACA	TGCTAGATAGACACCAAGAGCACAAGGTAA	SPTAN1_p.R402G
TTTGGTAGTCACTCACTCTCACTA	CCCGATAATAGCTACTGGT	TGCTACCCGATAATAGCTACTGGTAGGTAT	NT_nontargetX
TTTGAGCACATACATATCACTCTG	TGTaCTCCCCCATGAAGGA	TGCGGTGTACTCCCCCATGAAGGATGGGAA	MYO16_p.Y395C
TTTGTACACATCTCACATCACATA	GGCTaCTACAACCAGAGCG	TGCGCGGCTACTACAACCAGAGCGAGGCCG	HLA-A_p.Y108C
TTTGCTCACTCTCACTACTCACAG	GGCTaCTACAACCAGAGCG	TGCGCGGCTACTACAACCAGAGCGAGGCCG	HLA-A_p.Y108C
TTTGCTCATCATCACTACTCTATA	GAACaAAGTGATAATGAGC	TGCCTGAACAAAGTGATAATGAGCTGGAGC	ESCO1_p.Q287R
TTTGACTACTCACAGCACGTCACA	CAGaCATGCCACGGAGCCC	TGCCTCAGACATGCCACGGAGCCCTGGTGC	BSN_p.D1516G
TTTGTCACTCACACACGCACGTAT	CAGaCATGCCACGGAGCCC	TGCCTCAGACATGCCACGGAGCCCTGGTGC	BSN_p.D1516G
TTTGTGTCATCACTATACTCTGAC	ACCaGGACGGGGAGCTGCA	TGCCTACCAGGACGGGGAGCTGCAGGGCTC	NPTXR_p.Q397R
TTTGGCACTCACATCGTCACATAG	ACCaGGACGGGGAGCTGCA	TGCCTACCAGGACGGGGAGCTGCAGGGCTC	NPTXR_p.Q397R
TTTGCATGCACTCTACATCGTACA	TTCTaCGTGTCGCTGCTGC	TGCCGTTCTACGTGTCGCTGCTGCTGGGGC	KCNG2_p.Y263C
TTTGATATCAGTCACACGTCACAT	CCAGaCCATCATGTAGCGG	TGCCGCCAGACCATCATGTAGCGGTGGACA	LINS_p.D327G
TTTGCATCTCTCTACACAGCACAG	CGCaGCTGCACCTGCACTG	TGCCACGCAGCTGCACCTGCACTGGGGGAA	CA12_p.Q117R
TTTGTGACATCACTCTGACTCACA	GCCaTGGTTCTCCTGAAGC	TGCATGCCATGGTTCTCCTGAAGCTGGGCC	TICAM1_p.M46V
TTTGAGTCTCTATCGATATCTATA	TGGaGCCTCCTAGTGGCCG	TGCAGTGGAGCCTCCTAGTGGCCGTGGGTG	TMEM141_p.S63G
TTTGGACAGCTATCTCGTCACTCG	TACTaCAACAAGGTAAGAT	TGCAGTACTACAACAAGGTAAGATGGGCCC	CELSR1_p.Y1535C
TTTGCTCGCACTCACACACGCTCG	GCTGaGATCGAGGAGCTGC	TGCAGGCTGAGATCGAGGAGCTGCGGGCCA	MYH2_p.E1690G
TTTGTGACATCGCACATCTCTGCT	GCTCaGCATGTGTCGTACC	TGCAGGCTCAGCATGTGTCGTACCGGGAGC	SLC25A39_p.Q184R
TTTGAGTACATCACGTATATCACT	GCTCaGCATGTGTCGTACC	TGCAGGCTCAGCATGTGTCGTACCGGGAGC	SLC25A39_p.Q184R
TTTGTGCACATCACTCATCAGTAG	GCCCaGGCTGAGTCACTCC	TGCAGGCCCAGGCTGAGTCACTCCAGGAAA	DEFA5_p.Q18R
TTTGATATAGTCTCACACTACTCG	GCACaGCTTCGGTCCAAAG	TGCAGGCACAGCTTCGGTCCAAAGAGGCTG	ODF2_p.Q328R
TTTGTACAGCACTCACTGCACGTC	GAGGaCGCGGTGGCCCCGG	TGCAGGAGGACGCGGTGGCCCCGGCGGCGG	ZNF536_p.D266G
TTTGCTCTCGCACATACACATCAC	CCCCCaAGCAACCTGTGGG	TGCAGCCCCCAAGCAACCTGTGGGCGGTGG	NOLC1_p.K407E
TTTGACATCACATCATCTATCGAG	ATTTaTGTTCCTCTCATGC	TGCAGATTTATGTTCCTCTCATGCTGGTTA	ABHD2_p.Y334C
TTTGTACAGTACACACACACTCAG	ATTTaTGTTCCTCTCATGC	TGCAGATTTATGTTCCTCTCATGCTGGTTA	ABHD2_p.Y334C
TTTGGAGACACACACGTCTATCTA	GTACaTCATGCTCAGCGGC	TGCACGTACATCATGCTCAGCGGCCGGCTG	PNPLA7_p.I615V
TTTGGCTACTACTCATATATCATG	ATaTGTCACGTGGCACGGA	TGCACATATGTCACGTGGCACGGAAGGAGG	CAD_p.I1612M
TTTGTGATCATCACACTACTATAG	AGAaAAGAGTCCGATCAAG	TGCACAGAAAAGAGTCCGATCAAGAGGTAA	SP140_p.K568R
TTTGTCACTGTACACATCATCGCA	TTTTCaCAAGAAGTAATCC	TGATGTTTTCACAAGAAGTAATCCTGGTTT	MBD5_p.T251A
TTTGCGCTATCACTCATCTACGAG	TTGGaGAATTATAGGAACC	TGATGTTGGAGAATTATAGGAACCTGGCCT	ZNF347_p.E39G
TTTGACTACTCTGCATCGTCATAT	TTGGaGAATTATAATAACT	TGATGTTGGAGAATTATAATAACTTGGTCT	ZNF540_p.E37G
TTTGTGACTACTCTCTCACTATAG	TTAaCTGCAAAGATGCTGA	TGATGTTAACTGCAAAGATGCTGATGGTCG	ANKRD50_p.N940S
TTTGGCATCACTCTAGCTCTACTA	GCGCaGGCCAATGTGTCCA	TGATGGCGCAGGCCAATGTGTCCAGGGCCA	NACAD_p.Q1534R
TTTGCACTCATCTGTCTATCACGC	GCGaGGAAGCGGAGCCGGA	TGATGGCGAGGAAGCGGAGCCGGAGGGGAT	TMPRSS6_p.E20G
TTTGTCTCACACATGTACTACACT	CTCTaCGCTGGCCGCTCTC	TGATGCTCTACGCTGGCCGCTCTCAGGACG	BCKDK_p.Y77C
TTTGAGCTCGTCTATCACTCATCG	ATaGAAGAGGAGATGAAAG	TGATGATAGAAGAGGAGATGAAAGAGGAGA	C20ORF20_p.I122M
TTTGTGTCAGTCACGTATATCACA	ATaGAAGAGGAGATGAAAG	TGATGATAGAAGAGGAGATGAAAGAGGAGA	C20ORF20_p.I122M
TTTGCGTACATATCACAGTCACAT	TTCaTGGGTTACCAGAACG	TGATCTTCATGGGTTACCAGAACGTGGAGG	PALM_p.M303V
TTTGGCATCACTACACATCTAGCT	TTCaTGGGTTACCAGAACG	TGATCTTCATGGGTTACCAGAACGTGGAGG	PALM_p.M303V
TTTGGACACACATCTCATATCACT	AGTaCATAGTCACTGGCTC	TGATAAGTACATAGTCACTGGCTCGGGGGA	TLE1_p.Y753C
TTTGCAGCACAGTCTCACTCACTG	TACaAGGCACTAATAGTTC	TGAGTTACAAGGCACTAATAGTTCTGGATC	CBLL1_p.Q9R
TTTGGCTCAGATCATCATCTCTAT	GTGaGTCTCCCTTTCAGTG	TGAGTGTGAGTCTCCCTTTCAGTGGGGAGA	ZNF418_p.E193G
TTTGCTCTCTATCTATGTCTATAC	TGGGCaCTCACCCCAGGAT	TGAGGTGGGCACTCACCCCAGGATGGGTAA	OVGP1_p.T603A
TTTGCTGCTCACATCTCTATACAG	TCATaGGAGTGTGCAGAAC	TGAGGTCATAGGAGTGTGCAGAACAGGACT	SYT10_p.I464M
TTTGTCGCACTCTCAGTCTCTGTA	TCATaGGAGTGTGCAGAAC	TGAGGTCATAGGAGTGTGCAGAACAGGACT	SYT10_p.I464M
TTTGTAGCTCACAGTCACACACAC	GACaAGCGCCTGGAGAAGA	TGAGGGACAAGCGCCTGGAGAAGATGGTCA	LRRC47_p.K240E
TTTGGATCACATATCGATACTCTC	GACaAGCGCCTGGAGAAGA	TGAGGGACAAGCGCCTGGAGAAGATGGTCA	LRRC47_p.K240E
TTTGACACTCTCAGTCACGCACGA	CGGCaGCAGAAGCTAAAGC	TGAGGCGGCAGCAGAAGCTAAAGCAGGCCA	DNAJC21_p.Q241R
TTTGGCTACGTCACACATCTCGCT	ACAaGGTGAGAAGCCAAGG	TGAGGACAAGGTGAGAAGCCAAGGAGGCTG	BSG_p.K264R
TTTGATACAGCACTCTCTCATCTG	GCCCCaTTCCAGCTGGGGA	TGAGCGCCCCATTCCAGCTGGGGATGGGAA	TACC2_p.I1785V
TTTGTCACAGTCATATCATCACGC	GCCaCCGAGAAAGCCCGCC	TGAGCGCCACCGAGAAAGCCCGCCGGGAGA	AZI1_p.T684A
TTTGATGTCAGCACACTCGTCATC	CTGGaCGAGCGGCGGCAGC	TGAGCCTGGACGAGCGGCGGCAGCTGGACG	MMRN2_p.D523G
TTTGCTCGTATACTCTACTCATCG	CTGaCACCACCGCACCATC	TGAGCCTGACACCACCGCACCATCAGGGCA	CACNA1E_p.D1681G
TTTGACTAGTCACTACACGCACAC	CGCaCCAACCTCAAGGCCG	TGAGCCGCACCAACCTCAAGGCCGAGGCCG	CHDH_p.T252A
TTTGGTCTATGCACATCAGTCTCT	CGCaCCAACCTCAAGGCCG	TGAGCCGCACCAACCTCAAGGCCGAGGCCG	CHDH_p.T252A
TTTGTCTCTCTACACGTCACTCGA	TGTaCGACCTGGACGGCGA	TGAGATGTACGACCTGGACGGCGACGGGCG	HPCAL4_p.Y108C
TTTGGTATAGTCTACATCTACGTA	ATCaGGGAGAGGGCAAAGA	TGAGAATCAGGGAGAGGGCAAAGATGGAGA	ZFHX3_p.Q2304R
TTTGATACTCACACATACATATCA	ATCaGGGAGAGGGCAAAGA	TGAGAATCAGGGAGAGGGCAAAGATGGAGA	ZFHX3_p.Q2304R
TTTGCGCACATACACTCATCTACT	AATGaGCAGGCCAGTGTGG	TGAGAAATGAGCAGGCCAGTGTGGAGGAGC	ZNF407_p.E1472G
TTTGTAGCACTCACATGCTCTAGT	GGGaAAAATGCTCAAGTGG	TGACTGGGAAAAATGCTCAAGTGGTGGTCA	LRP1B_p.K2352E
TTTGCTGTCACTCTAGCTCTCGCA	GGGaAAAATGCTCAAGTGG	TGACTGGGAAAAATGCTCAAGTGGTGGTCA	LRP1B_p.K2352E
TTTGTATCAGTACGATCACATCTA	CGTCaCATGCGGAGCCACC	TGACGCGTCACATGCGGAGCCACCTGGGCC	HIC2_p.H551R
TTTGGACACTACATACTCTATACA	TGTGCaGTGTGAGGGACAA	TGACCTGTGCAGTGTGAGGGACAATGGCAC	TECTA_p.S556G
TTTGTCACAGCTCACGCACATACT	GCCGaGATCCTGGAGCTGG	TGACCGCCGAGATCCTGGAGCTGGCGGGCA	HIST2H2AC_p.E62G
TTTGAGCACTCTCATCAGCTCTGC	GAGTCaCCATCGCGGAGCT	TGACCGAGTCACCATCGCGGAGCTGGGAGT	TMEM132B_p.T656A
TTTGGCATCTACTACTCGTATATA	CAGaTGAGGTAAGGAAGGA	TGACCCAGATGAGGTAAGGAAGGAGGGGCT	ETS1_p.D369G
TTTGATCATGTCACATCACGTCAG	AGTaTGTTGTCAGGGTCCA	TGACCAGTATGTTGTCAGGGTCCAAGGTAA	TRUB1_p.M142V
TTTGCGCATCGCACATCTCGTCTA	AGTaTGTTGTCAGGGTCCA	TGACCAGTATGTTGTCAGGGTCCAAGGTAA	TRUB1_p.M142V
TTTGTCTATGCTCATATCACGCGT	AATGaCTGGGAAGATCACT	TGACCAATGACTGGGAAGATCACTTGGCAG	HSP90AA1_p.D441G
TTTGATCTATACTCATCAGCACTA	GAAAAaGGGTGCAGACGTC	TGACAGAAAAAGGGTGCAGACGTCTGGTTC	S100A8_p.K49R
TTTGCTCTCTCATCTGCTCTATAT	GAAAAaGGGTGCAGACGTC	TGACAGAAAAAGGGTGCAGACGTCTGGTTC	S100A8_p.K49R
TTTGCATCATATCATATCATCGAC	GGCaTGTGGAGAAAAGCAG	TGAATGGCATGTGGAGAAAAGCAGCGGAAA	JMJD1C_p.H1071R
TTTGTACGTCACTCGCACTATCTG	GCGCaCCTGCGCTGGCACA	TGAAGGCGCACCTGCGCTGGCACACGGGCG	SP5_p.H316R
TTTGTATCATCACAGTCAGCTCGT	AGGaGGAGCCTGGGGGTCT	TGAAGAGGAGGAGCCTGGGGGTCTCGGTCC	OVOL2_p.R10G
TTTGTGTACTCATCACACTGCATA	AGGaCGATGGCCGTGGCCG	TGAAGAGGACGATGGCCGTGGCCGGGGCCT	FAM116A_p.D45G
TTTGTAGTCATCTCACTGCTCTAG	GAGTaCAGTCGGTCCTCGG	TGAAAGAGTACAGTCGGTCCTCGGCGGATC	MCM3AP_p.Y676C
TTTGAGATACATCTCATATACGTC	GAGTaCAGTCGGTCCTCGG	TGAAAGAGTACAGTCGGTCCTCGGCGGATC	MCM3AP_p.Y676C
TTTGCTCTATCATATACTCACTAC	CTTGaTACCATGATCTTCG	TGAAACTTGATACCATGATCTTCGGGGTGA	GUCY2C_p.D554G
TTTGAGTCACATATACTCGATACT	AGGaAAGGCTTGGTAAAAA	TGAAAAGGAAAGGCTTGGTAAAAAAGGTTC	BAG1_p.K309E
TTTGTAGCTCTCTATCATCTCAGC	AGGaAAGGCTTGGTAAAAA	TGAAAAGGAAAGGCTTGGTAAAAAAGGTTC	BAG1_p.K309E
TTTGCTCATCTCTATCACGCACAT	TGTCaAGAGGAACCGGTGG	TCTTTTGTCAAGAGGAACCGGTGGTGGCTA	TOR1AIP1_p.K334E
TTTGTATACATATCTACGTCTGTA	TAGGGaTGCGGAAAGAAAG	TCTTTTAGGGATGCGGAAAGAAAGCGGAAA	NOP14_p.D826G
TTTGGTACTACACTACACATATGT	CTGAaCTGGACAGAGGGTC	TCTTTCTGAACTGGACAGAGGGTCAGGAGA	PILRB_p.N100S
TTTGACACGCACTCATATCTCTAC	CTCaTGGGAGCCAACACTC	TCTTTCTCATGGGAGCCAACACTCAGGACA	CD1E_p.M350V
TTTGTCTGCATATCACTATCGATC	CTATaGTGGGAAGTTGCTG	TCTTTCTATAGTGGGAAGTTGCTGAGGTGG	NUP205_p.001
TTTGACTCACAGCTCAGCACTACT	CACCaCAAGTTTGAGATCC	TCTTTCACCACAAGTTTGAGATCCTGGATG	HVCN1_p.H168R
TTTGCATGTACTACATACATACAG	AAGaCTGTGACATCAGGCA	TCTTTAAGACTGTGACATCAGGCATGGCTC	OPA1_p.T460A
TTTGCATGTACTACTCACATACTC	TGGaGGTAAATCTGCAGAA	TCTTCTGGAGGTAAATCTGCAGAATGGCAT	PCDHA7_p.E76G
TTTGACTATCTACACTCATCAGTA	TCCCaGTTTGGCCAGATCC	TCTTCTCCCAGTTTGGCCAGATCCTGGATA	SNRPA_p.Q36R
TTTGTCATGCTCTACAGCATCATA	GGCAaTGGCCTGGTGTGCA	TCTTCGGCAATGGCCTGGTGTGCATGGCTG	DRD3_p.N47S
TTTGTGATCACTCATACACAGATC	GCaATTTCAGTGCGGCCGA	TCTGTGCAATTTCAGTGCGGCCGATGGCGG	LY6E_p.N99D
TTTGGTCTCTATCATCTACAGCTA	GATGaTGGATGGACTGATA	TCTGTGATGATGGATGGACTGATAAGGATG	PRSS12_p.D527G
TTTGCGACACTACACTCTCGCTCA	AGCCaGGAAAGAGCGGGGC	TCTGTAGCCAGGAAAGAGCGGGGCTGGCGG	MRPL18_p.R63G
TTTGATGTCTACTCACATATCACA	GGGAaGGCCTTCCCCTGGA	TCTGCGGGAAGGCCTTCCCCTGGATGGTCC	ZSCAN1_p.K387R
TTTGTACACACTCTAGCACACTCG	GACATaAATACGAACACAC	TCTGCGACATAAATACGAACACACAGGTAT	ZEB2_p.K1018E
TTTGCTACAGTACACACATCATAC	ATCTaCCATGATTGACCAG	TCTGCATCTACCATGATTGACCAGTGGTAT	ATP10A_p.T1116A
TTTGATATCATCTAGTACATCTAC	GGCCaTCTTCCTCGAGGCA	TCTGAGGCCATCTTCCTCGAGGCAAGGCCC	PRPF6_p.I818V
TTTGGACTACTCATCTATCTCGTA	AGGaGGCTTGTGACCAGCA	TCTGAAGGAGGCTTGTGACCAGCATGGTCC	CPOX_p.E302G
TTTGATACACTACTCTACTCTGAC	AGGaGGCTTGTGACCAGCA	TCTGAAGGAGGCTTGTGACCAGCATGGTCC	CPOX_p.E302G
TTTGTACTACAGTACACTACTCAG	AGaTCTTCCCGACGAAGTC	TCTGAAGATCTTCCCGACGAAGTCAGGGAA	PPP6R3_p.D436G
TTTGTACAGTCACAGTCACAGTCA	AGaTCTTCCCGACGAAGTC	TCTGAAGATCTTCCCGACGAAGTCAGGGAA	PPP6R3_p.D436G
TTTGCTCTCATCTCACAGCGTCGA	GGCCACGAATTCCGCCGCC	TCTCTGGCCACGAATTCCGCCGCCAGGATA	NT_nontargetX
TTTGTCGCTCTACATCTACACAGA	TTCaTGGATGAGGAGGAGG	TCTCCTTCATGGATGAGGAGGAGGAGGATG	CDC42EP4_p.M346V
TTTGCAGCACTCACTACATATCTA	GTGGaCCGCTACCTGGCTG	TCTCCGTGGACCGCTACCTGGCTGTGGCCC	GPR68_p.D128G
TTTGTGCTCTACAGTACACACTAT	CAGaCGCTGCAGCGCTCAC	TCTCCCAGACGCTGCAGCGCTCACTGGCCA	RHPN1_p.T443A
TTTGGACACTACTCTCTCGCACAC	GGTaTTCACGCCCTGCTGG	TCTATGGTATTCACGCCCTGCTGGTGGTCG	PFKL_p.I536V
TTTGACTCACACACACATCTGATA	GCCAaCCTCAGCGTGCCTG	TCTATGCCAACCTCAGCGTGCCTGTGGTTA	P4HA3_p.N482S
TTTGACGCACACATCTACACTCAG	CCCaTGACAGCAGGTGAGC	TCGTGCCCATGACAGCAGGTGAGCAGGACG	PPIE_p.M167V
TTTGACTCTCACTCATATATCACA	GACGCaCAGGTAGGCACAG	TCGGTGACGCACAGGTAGGCACAGCGGGCC	KSR1_p.H348R
TTTGGACATCTATATCATCGCTGC	TGAGCaGCGGCGGCGGCGG	TCGGCTGAGCAGCGGCGGCGGCGGCGGCGG	SMG1_p.S12G
TTTGCGTACATCTCTACATACTCG	CTCaGGCTCTCATTGAGTG	TCGGCCTCAGGCTCTCATTGAGTGCGGAGG	FER1L6_p.Q1016R
TTTGCAGCTACTATCGTCTACATC	CGGGaCTCCACCTACGAGC	TCGGCCGGGACTCCACCTACGAGCAGGAGG	GRM6_p.D392G
TTTGTCTGCTACACATCACACAGC	GAGaGGGGTCAGAAGCTTG	TCGCTGAGAGGGGTCAGAAGCTTGAGGATT	SPTA1_p.R45G
TTTGTGATCACGTCACTAGCACAT	GAGaGGGGTCAGAAGCTTG	TCGCTGAGAGGGGTCAGAAGCTTGAGGATT	SPTA1_p.R45G
TTTGCATGTCACTCTCGTCATATA	GATCaTTAAGACCCCTCGG	TCGCGGATCATTAAGACCCCTCGGCGGTTT	KMT2A_p.I422V
TTTGCACAGTATATATCACTCGAT	GATCaTTAAGACCCCTCGG	TCGCGGATCATTAAGACCCCTCGGCGGTTT	KMT2A_p.I422V
TTTGTCATCTCACACTCATCTAGC	GAGGCaATTTGTGTTCAGG	TCGAGGAGGCAATTTGTGTTCAGGTGGTGC	UBR3_p.N1469D
TTTGTGCTGCACTCTACACTGCAC	CTCCaGATCAAAAAGCTCA	TCGAGCTCCAGATCAAAAAGCTCAAGGTAG	SYNE1_p.Q8093R
TTTGGTCAGCTCTAGCTCACTATA	CCCaAAGAAGGCAAGTTTG	TCGACCCCAAAGAAGGCAAGTTTGTGGGCC	PAK6_p.K29E
TTTGTACATCTGTACATCGCGTCG	CACaTGGTCCCGCTGGTAG	TCGACCACATGGTCCCGCTGGTAGAGGAGA	C7ORF26_p.M322V
TTTGTCGATACTCACTCATAGTCT	CACaTGGTCCCGCTGGTAG	TCGACCACATGGTCCCGCTGGTAGAGGAGA	C7ORF26_p.M322V
TTTGCTGTCAGCTCACTACTACTA	GATaTGGTGAGACTTGGGA	TCGAAGATATGGTGAGACTTGGGAAGGATT	ACSL1_p.M638V
TTTGTAGACATCATACACATATCT	TGATaAGGTCAAGGAGCCT	TCCTTTGATAAGGTCAAGGAGCCTCGGAAG	SAFB_p.K607E
TTTGCTCATGCTCGCTCTCTACAT	TAAGGCCCGCGTACGAGCT	TCCTGTAAGGCCCGCGTACGAGCTAGGGGC	NT_nontargetX
TTTGCACTATCATATCAGTCTACT	AGGaGTGAGTTGTCCACCC	TCCTGAGGAGTGAGTTGTCCACCCAGGGGA	CAMKK1_p.E375G
TTTGCTCATCAGCTACGCTACTCG	AGGaGTGAGTTGTCCACCC	TCCTGAGGAGTGAGTTGTCCACCCAGGGGA	CAMKK1_p.E375G
TTTGCGCATATACACTACTCACAC	AAGaGTGACCATCCTGCTG	TCCTGAAGAGTGACCATCCTGCTGTGGCAC	PDGFRA_p.S972G
TTTGTCTCTACTACACAGTATCAC	AAGaGTGACCATCCTGCTG	TCCTGAAGAGTGACCATCCTGCTGTGGCAC	PDGFRA_p.S972G
TTTGTACATCAGTCACATCACTCA	GCCCaTAGCTAAGGACCCG	TCCTCGCCCATAGCTAAGGACCCGAGGTAT	SNTG2_p.I206V
TTTGATATCATATATCACTCAGTC	CGGCaTGGCAAGCTGGTGC	TCCTCCGGCATGGCAAGCTGGTGCTGGACA	KCTD17_p.H87R
TTTGTCACTACTGTCACACATCTG	CCAaCCAGAAGGGACCAAG	TCCTCCCAACCAGAAGGGACCAAGTGGTGT	ARHGAP31_p.N1021S
TTTGATCTCATACACGTCATATCA	AACaGCGGCACCAGCTTTG	TCCTCAACAGCGGCACCAGCTTTGTGGCCG	SLC6A13_p.S322G
TTTGCTACATCACTGCTCTCATAT	GGTGaCTCCATAATGCAAC	TCCTAGGTGACTCCATAATGCAACTGGTAG	DROSHA_p.D1151G
TTTGTCGTACTCTCACTATACTCA	GAAaGCAACCCAAAGTGGG	TCCTAGAAAGCAACCCAAAGTGGGAGGCAC	ERCC4_p.S377G
TTTGCATCGCTCACACATAGTCTA	GTTaAGTGGACAAAGGATG	TCCGTGTTAAGTGGACAAAGGATGGGGCCA	TMIGD2_p.K58E
TTTGCTCTCTCTCATCTCTCTCTG	CTGGaTGAGGCTGAGCAGC	TCCGTCTGGATGAGGCTGAGCAGCTGGCGC	MYH4_p.D1802G
TTTGGACACATCTACATGCATCGT	GCCCaCATCGACAAGCTGA	TCCGGGCCCACATCGACAAGCTGACGGGGA	KIF1C_p.H836R
TTTGCGCTACACTCATCGTCGTCT	GCCCaCATCGACAAGCTGA	TCCGGGCCCACATCGACAAGCTGACGGGGA	KIF1C_p.H836R
TTTGACTCTATCTCTAGATCTATC	CTGGaCTGCCCAGCAGCTG	TCCGCCTGGACTGCCCAGCAGCTGTGGTTG	NRIP3_p.D181G
TTTGATGTATATCTACTACATCAG	GGTGCaGCACTGCAATGAA	TCCCTGGTGCAGCACTGCAATGAATGGCAG	DNAH2_p.Q1026R
TTTGAGCTCACTCACTCTATACAC	GAGGaCAAGAATCCCTTCA	TCCCTGAGGACAAGAATCCCTTCAAGGAGA	GNGT2_p.D56G
TTTGATGCTCTCTACTACAGCATA	CTTCaGGTATGGAGAGAAG	TCCCTCTTCAGGTATGGAGAGAAGGGGAAA	K0401_p.001
TTTGTCACACATCACTCTAGTCTG	TTCaGCCTCATCGTGAGTC	TCCCGTTCAGCCTCATCGTGAGTCAGGACG	C20ORF114_p.S281G
TTTGTATCGACACACATCGCACAC	AGGACaTGTGTGTGGTATG	TCCCCAGGACATGTGTGTGGTATGTGGCAG	KMT2D_p.M1106V
TTTGCGCTACATCATATCACTCGC	AGGACaTGTGTGTGGTATG	TCCCCAGGACATGTGTGTGGTATGTGGCAG	KMT2D_p.M1106V
TTTGCGACACACTCTATCAGCACT	AACCTaTCAATCCCCTGGT	TCCCAAACCTATCAATCCCCTGGTAGGTTT	PDYN_p.I40V
TTTGACAGTCATCTATATACTCAG	CTTTCaGAAATCAGAGCGA	TCCATCTTTCAGAAATCAGAGCGAGGGGGG	ADARB1_p.Q427R
TTTGCGCACTCACATGCTCTAGTC	CAAGCaGGTACTGAAAGAA	TCCACCAAGCAGGTACTGAAAGAAGGGCTG	NFIB_p.S269G
TTTGCTCACTCTCTACACAGTAGT	CAAGCaGGTACTGAAAGAA	TCCACCAAGCAGGTACTGAAAGAAGGGCTG	NFIB_p.S269G
TTTGCTACACTACACGCGTACTCA	GGGGGaCTGTGGCTCTTGT	TCCAAGGGGGACTGTGGCTCTTGTGGGGGC	KRTAP5-10_p.D73G
TTTGCTACACTGCTCACTAGTCAT	GATaCTATGATGAGCAACA	TCATTGATACTATGATGAGCAACACGGAAT	C17ORF57_p.T588A
TTTGCGTCACACTCTCACATATGC	GCGGCaGCAGCAGCAGTGG	TCATGGCGGCAGCAGCAGCAGTGGGGGCAG	EMILIN1_p.S268G
TTTGCACATATCTAGATACTCACT	GAGTaCGCCAACGGGGGCG	TCATGGAGTACGCCAACGGGGGCGAGGTAG	AKT1_p.Y229C
TTTGTATGTCTACATACTCGTATA	GAGTaCGCCAACGGGGGCG	TCATGGAGTACGCCAACGGGGGCGAGGTAG	AKT1_p.Y229C
TTTGTAGATCTACATACTACGTCG	TTATaGGTCTACCAGGAAG	TCATCTTATAGGTCTACCAGGAAGAGGATT	COL4A1_p.001
TTTGAGACTCGCACGTACTCTCAC	GACaGTGATGCCGCTGCAG	TCATAGACAGTGATGCCGCTGCAGAGGCTA	SCGB2A1_p.S52G
TTTGCGCACTCACACTACACTCTA	GCCTaTGAAGCTGAGCTAG	TCAGTGCCTATGAAGCTGAGCTAGAGGCTC	CNTRL_p.Y186C
TTTGCTCACTCTGCGTATCATCAC	GCCaTCAAGACCCTGTGGG	TCAGTGCCATCAAGACCCTGTGGGAGGACC	GNA11_p.I132V
TTTGATGTCTACTACTACATACTC	GCCaTCAAGACCCTGTGGG	TCAGTGCCATCAAGACCCTGTGGGAGGACC	GNA11_p.I132V
TTTGTCGTCATCTACTATCATCAC	TATaTaAGTGTGATCCTGC	TCAGGTATATAAGTGTGATCCTGCAGGTTA	PSMA6_p.K153E
TTTGATCTACTCATCGTACTCACT	CCCaTCAGAGAGTCCATAC	TCAGGCCCATCAGAGAGTCCATACAGGAGA	ZNF233_p.H480R
TTTGCTCACTGCATCACTCATCAC	TGCaGAGGCAAGTGGGGTT	TCAGCTGCAGAGGCAAGTGGGGTTTGGAGA	DHRS2_p.Q243R
TTTGTCACTACTAGCATATCACAC	CTCaTTAAGGTGAAATTTG	TCAGCCTCATTAAGGTGAAATTTGAGGATA	RNMTL1_p.I166V
TTTGCACTACACTATCAGATCGTA	AGAaGCCAATCTTAAATCT	TCAGCAGAAGCCAATCTTAAATCTAGGTAA	KIAA1797_p.K326R
TTTGCATCGTCACACTACAGCATC	GGAaCAAACAGATAGCCAT	TCAGAGGAACAAACAGATAGCCATGGGAAG	CYTH3_p.N67S
TTTGCATACTCACTACTGCTACAT	AGGaGGTGAGAGGGCCGGG	TCAGAAGGAGGTGAGAGGGCCGGGAGGTGA	POLD1_p.E1040G
TTTGTACTGCATCATCAGCGTCAG	GTCCaCGGCACTCAGGGCC	TCACTGTCCACGGCACTCAGGGCCCGGGGC	GUCY2D_p.T203A
TTTGATATGACACACTACACACAG	GCACaCCCCACCTCTCCAC	TCACTGCACACCCCACCTCTCCACCGGCAC	PTK2B_p.T765A
TTTGTACAGCTATCACTATCGATC	CTCaGCAACACACTGCACC	TCACTCTCAGCAACACACTGCACCAGGAGT	C9ORF174_p.S1001G
TTTGAGCATCTCATCACACGAGTA	CTCaGCAACACACTGCACC	TCACTCTCAGCAACACACTGCACCAGGAGT	C9ORF174_p.S1001G
TTTGTACACATGCTCACTCGATAT	CCGCaCCCCTGCAACGAGC	TCACGCCGCACCCCTGCAACGAGCTGGGGC	GRRP1_p.H53R
TTTGCTCATATCTACTGCGCACTA	TTCaGGGCTCCCAGGGCCC	TCACCTTCAGGGCTCCCAGGGCCCAGGCTG	FCRL5_p.R664G
TTTGGCACTCTGCTCACACAGCTC	TTCaGGGCTCCCAGGGCCC	TCACCTTCAGGGCTCCCAGGGCCCAGGCTG	FCRL5_p.R664G
TTTGGACTACACACACTATGTCAT	GGGaTGCCCAGGGTGAGGC	TCACCGGGATGCCCAGGGTGAGGCTGGCAG	C1ORF127_p.M523V
TTTGATCACGCACACACTAGCACT	CTGaTCCTGGTGGTCCTCA	TCACCCTGATCCTGGTGGTCCTCATGGGCT	LYNX1_p.I8V
TTTGGTATACACTCTATCGTCATC	ACCAaCCTGGCCATCTGGA	TCACCACCAACCTGGCCATCTGGATGGCGG	OTOP2_p.N180S
TTTGCTCTACATCATCGTCTAGTA	CTGCaACCGCACGTGAGTG	TCACACTGCAACCGCACGTGAGTGAGGCGG	EGFL4_p.N1048D
TTTGAGACACATCTGTCACGTCAT	AGCACaGTAATTCTGTAGG	TCAAGAGCACAGTAATTCTGTAGGCGGCCA	C18ORF25_p.S274G
TTTGCACTCGCACTCTACATCTGA	AGCACaGTAATTCTGTAGG	TCAAGAGCACAGTAATTCTGTAGGCGGCCA	C18ORF25_p.S274G
TTTGTATATCATATAGTCTACACA	AACaTATGAGTATTCACAC	TCAAGAACATATGAGTATTCACACAGGTAA	ZBTB11_p.H725R
TTTGGATACACTCATCACTCTAGA	AACaTATGAGTATTCACAC	TCAAGAACATATGAGTATTCACACAGGTAA	ZBTB11_p.H725R
TTTGGACACACGTCATCATATCAG	AAGaTCCGCAAGCAGCAGC	TCAACAAGATCCGCAAGCAGCAGCAGGTGC	MED20_p.I200V
TTTGTACTCATACTCTCACACTGC	TGATTaGAGATCCAGCCAG	TCAAATGATTAGAGATCCAGCCAGAGGATG	SUPV3L1_p.R297G
TTTGCTACTACAGCTATCACTCAC	GCCaGACACTTGCCGAAGA	TCAAAGCCAGACACTTGCCGAAGATGGATA	SYT11_p.R316G
TTTGCTAGTATCATCTCGCACTCA	TAGTaCTGATATGTCCATT	TATTTTAGTACTGATATGTCCATTGGGCAA	ATG2B_p.T600A
TTTGTGATACTCTCTCTACACGAT	GACGCaGAAAGTGAGTTGG	TATTTGACGCAGAAAGTGAGTTGGAGGAGG	SCN8A_p.Q91R
TTTGTCGTCTAGCTCACTCTCTAT	GAaTTCTACTGCGAGATCT	TATTGGAATTCTACTGCGAGATCTAGGGCT	BAG4_p.N104S
TTTGCAGTCACATGTCACTACTCG	TACaTCAGAGAAAACACAC	TATTATACATCAGAGAAAACACACAGGGGA	ZNF25_p.H416R
TTTGATACATCTACTCGATATCAT	CTCaGTGGGTCGACGACGG	TATGTCTCAGTGGGTCGACGACGGTGGCTA	CUL9_p.Q2208R
TTTGCACTGTCACATCGACACACT	ATaTGAACTGTGAATCCCA	TATGGATATGAACTGTGAATCCCATGGTCC	ZDBF2_p.M659V
TTTGTGACTCTACTCGTCATCGCA	CGTCGTTTAGCACCCGGCT	TATCACGTCGTTTAGCACCCGGCTAGGCAC	NT_nontargetX
TTTGCACTGCTATCAGTACATCAT	AAGATCCGCGGGTGGCAAC	TATATAAGATCCGCGGGTGGCAACAGGATC	NT_nontargetX
TTTGACACATCTCTCTAGACTCTG	GCCaCGTAGAATATAGTCA	TATAGGCCACGTAGAATATAGTCATGGAAC	FRAS1_p.H2156R
TTTGCTACATCACACACGCGTATC	GCCaCGTAGAATATAGTCA	TATAGGCCACGTAGAATATAGTCATGGAAC	FRAS1_p.H2156R
TTTGAGATCTCACTCACATAGCTC	ATTGaCCTAGAAGCTGAGA	TATAGATTGACCTAGAAGCTGAGAAGGTGA	NHLRC2_p.D305G
TTTGATACTCATCATCTCTATACT	TATGaCTATTACGGTGGGG	TATACTATGACTATTACGGTGGGGAGGTGG	PRSS54_p.D357G
TTTGCATGTCACTCTAGCTCACTC	TTGCTaAAGGATTTTGGGC	TAGTTTTGCTAAAGGATTTTGGGCCGGAGT	CEP350_p.K2523E
TTTGCAGTCTCAGCTCACATCTAG	TGTaCTATGTCGTCGAAGG	TAGTGTGTACTATGTCGTCGAAGGAGGAGT	YOD1_p.Y122C
TTTGTATACACACATCGTATATAC	TGTaCTATGTCGTCGAAGG	TAGTGTGTACTATGTCGTCGAAGGAGGAGT	YOD1_p.Y122C
TTTGAGCATACACTCATCACGCAT	TGTaCAGCTACGTTAGCCT	TAGTGTGTACAGCTACGTTAGCCTGGGGTG	ASCC3_p.T809A
TTTGGCGACTCTACACACTCTCGC	CGAGaGAAAGCGGCTCTAG	TAGTACGAGAGAAAGCGGCTCTAGAGGTGC	CEP250_p.E737G
TTTGCGTCATCAGTCATCGCATAT	GGGACGTCGCGAAAATGTA	TAGGCGGGACGTCGCGAAAATGTAAGGCGC	NT_nontargetX
TTTGGATATCTACTACTCTGTCGA	CATGaGGCAGCCGGCATCG	TAGGCCATGAGGCAGCCGGCATCGTGGAGA	ADH1A_p.E69G
TTTGGCTCATCGTATACTCAGTCA	GCTGaGGATAACTATACCT	TAGGAGCTGAGGATAACTATACCTTGGTCA	MARS_p.E572G
TTTGACGTCATCTAGCTACTACAG	CCCaGTTCAAGTGCAACAG	TAGCACCCAGTTCAAGTGCAACAGCGGGCG	LRP1_p.Q1019R
TTTGCTCATACTCAGTCACACTAT	GGGGaCAAAACAGTGACTG	TAGATGGGGACAAAACAGTGACTGTGGAGT	SEC24C_p.D786G
TTTGCTACACTCATCACTCGCACG	GACaCTGAGCTCCGGCTGT	TAGATGACACTGAGCTCCGGCTGTTGGGAC	RSAD1_p.T163A
TTTGCACTCACTCTCTACACATAC	CCAaTGGCTTAATTTGTGG	TAGATCCAATGGCTTAATTTGTGGAGGTAA	ITGB1_p.N564S
TTTGATGCTCTATACATCGTATAG	CCAaTGGCTTAATTTGTGG	TAGATCCAATGGCTTAATTTGTGGAGGTAA	ITGB1_p.N564S
TTTGGACTCATCACTGTATCATAT	GGGaGCATAGAGGGCCAGT	TAGAGGGGAGCATAGAGGGCCAGTCGGCTG	UNK_p.S182G
TTTGTCTATATCATGCACACACAT	ACTaCTGCCCCTGGAGTAG	TAGAGACTACTGCCCCTGGAGTAGAGGAGA	ACAN_p.T1289A
TTTGCAGACACACACAGTCAGCTA	TTAAaCTTCGGTCAGAAGG	TAGAATTAAACTTCGGTCAGAAGGAGGAGC	HNRNPUL2_p.N413S
TTTGCTCGTCTATATCATCTCGCT	TCCaTCAACGAACTCACAC	TACTGTCCATCAACGAACTCACACCGGAGA	ZFP2_p.H176R
TTTGCTGCATCGTCTATCATGCTC	GGTGaGGGCCGGCTTGCGC	TACTGGGTGAGGGCCGGCTTGCGCTGGAGA	PFAS_p.E179G
TTTGGCTATCACACAGTCTCATCG	AAGaTGCAGCTTCGGGAGT	TACGGAAGATGCAGCTTCGGGAGTTGGCTC	SF1_p.M242V
TTTGGCACATCTGTCATCTATCGC	AAGaTGCAGCTTCGGGAGT	TACGGAAGATGCAGCTTCGGGAGTTGGCTC	SF1_p.M242V
TTTGAGATCTATCACGCTCACACT	TTGGGaCATTAAACATGTT	TACGATTGGGACATTAAACATGTTGGGTAA	UXS1_p.T183A
TTTGCATGTCATATACTCTCACTA	GGAGCaGGTGAAGCGCCAG	TACCTGGAGCAGGTGAAGCGCCAGCGGGGT	FPGS_p.Q64R
TTTGGACTACTCACACATCGACTC	AGATaAAGAAGGTCCAGGT	TACCAAGATAAAGAAGGTCCAGGTTGGACC	MAMDC2_p.K355E
TTTGATCTATCATACATCTAGCAC	GAAaGTTAACAGGACACCT	TACAGGAAAGTTAACAGGACACCTAGGCCC	KIF21A_p.K1474R
TTTGTATATCTGCACACACGCACT	CTAaTGGGTTTCAGGTACA	TAATCCTAATGGGTTTCAGGTACATGGAAA	ZNF268_p.N225S
TTTGAGTCATAGCTCTATATCACA	CTAaTGGGTTTCAGGTACA	TAATCCTAATGGGTTTCAGGTACATGGAAA	ZNF268_p.N225S
TTTGACTGCTCGCACTATCTACTG	GCTACaAAAACCGCGTGGA	TAAGGGCTACAAAAACCGCGTGGAGGGCAA	TREML2_p.K106E
TTTGTACTATCGCACTCTCATATC	GCTACaAAAACCGCGTGGA	TAAGGGCTACAAAAACCGCGTGGAGGGCAA	TREML2_p.K106E
TTTGCACACGCTACATACTACATA	GGCCCGCATAGGATATCGC	TAACGGGCCCGCATAGGATATCGCAGGGGT	NT_nontargetX
TTTGCGTCTACTACTCGCACGATC	TTGGCaTGCTGCCCTATGG	TAACCTTGGCATGCTGCCCTATGGAGGTAT	LRRC7_p.M1298V
TTTGTCTGACTCACATATCTATCA	GCaGCCCAGAAGCTCCTGC	TAAATGCAGCCCAGAAGCTCCTGCAGGCAG	ZCWPW2_p.S308G
TTTGCTGATCACACTCTGCATCTC	GAGGaGGAGGAAGGCGCGG	TAAAGGAGGAGGAGGAAGGCGCGGAGGCCT	PGR_p.E390G
TTTGCACACTCACATCACTCATAG	GAGGaGGAGGAAGGCGCGG	TAAAGGAGGAGGAGGAAGGCGCGGAGGCCT	PGR_p.E390G
TTTGGTCACTACACACATGTCGCG	CTGTTaTAGTGGAAGTATC	TAAAGCTGTTATAGTGGAAGTATCAGGACA	C14ORF149_p.I324V
TTTGCTCTATCTGTCTATATCAGA	GATCaGGAGGATCTTAAAT	TAAAAGATCAGGAGGATCTTAAATGGGCTT	SYNE1_p.Q2118R
TTTGGTCAGCACACACATGCACAC	TATaGGCAGCCCTGCAAGT	GTTTTTATAGGCAGCCCTGCAAGTTGGGGG	DGKI_p.001
TTTGTCAGTCACACTCAGTCACGA	TGGTCaTGGAATACCTTGC	GTTTGTGGTCATGGAATACCTTGCTGGGGG	PAK2_p.M323V
TTTGCATCACTCTACATCATACAG	AGGaGGTGAGCACCAGGAT	GTTTGAGGAGGTGAGCACCAGGATGGGGAT	B3GAT3_p.E206G
TTTGAGCATCACGTCACTCTACGC	ACTaTCAGTTCCAGAGATA	GTTTGACTATCAGTTCCAGAGATATGGGTA	SETD2_p.Y1163C
TTTGATATACATCATACATACACA	ACTaTCAGTTCCAGAGATA	GTTTGACTATCAGTTCCAGAGATATGGGTA	SETD2_p.Y1163C
TTTGAGTCATCAGCTCGTCACATA	TCACaGCTGGAGTTGATCA	GTTTCTCACAGCTGGAGTTGATCAAGGATG	HNRNPC_p.001
TTTGTCAGCTCAGTCATCATCGTC	TCACaGCTGGAGTTGATCA	GTTTCTCACAGCTGGAGTTGATCAAGGATG	HNRNPC_p.001
TTTGCTACAGCACATATCATATCG	CTCaTCGCTGCCGGTGCAG	GTTTCCTCATCGCTGCCGGTGCAGTGGCCC	SLCO2B1_p.I282V
TTTGGCTGCATCATCGTCACTGTA	AGaTTGTTGTTATAATGAG	GTTTCAGATTGTTGTTATAATGAGAGGATT	YLPM1_p.I1640V
TTTGTCTATCACTATCACTCTACT	AGaTTGTTGTTATAATGAG	GTTTCAGATTGTTGTTATAATGAGAGGATT	YLPM1_p.I1640V
TTTGCTAGTCTGCTACATATATAT	CTGAaGTCTGAGGTGAGGG	GTTGTCTGAAGTCTGAGGTGAGGGAGGTAG	ODF2_p.K114R
TTTGTATCACACTCATCATACTAT	AGGTaCTGACATTGTGCAG	GTTGCAGGTACTGACATTGTGCAGTGGCTT	RGS6_p.T63A
TTTGCTCTGCTCTACATCACTCGT	GGACCaGCAACCCTCAGCA	GTTCTGGACCAGCAACCCTCAGCACGGCGG	FZD1_p.S249G
TTTGTCATCTGTCTACTACTCACG	GACaCCTTTCTTAATGACA	GTTCTGACACCTTTCTTAATGACATGGGGA	OR7A17_p.T192A
TTTGCGCTCTCACTACTACGCATA	GAGGaTTCCAGAAACATGA	GTTCGGAGGATTCCAGAAACATGAAGGAGA	GSDMB_p.D228G
TTTGGCTCTGTCACGTCACACTCA	CCCaGTGCTCCAGTACCTG	GTTCCCCCAGTGCTCCAGTACCTGTGGTCT	LYST_p.S3477G
TTTGGACACTATCACTGTCACTCG	CCTaTGTGGAGCTCCCCAG	GTTCACCTATGTGGAGCTCCCCAGTGGGAA	ITGB5_p.Y696C
TTTGGACACACTGCATACTCGCTC	TTGaaCGTTCCACAGACTA	GTTAGTTGAACGTTCCACAGACTATGGACA	LAMB4_p.E144E
TTTGATCATCTACACTCTCTCGCT	CGTGaCTCGGTAAGGGAGG	GTTAACGTGACTCGGTAAGGGAGGTGGATG	DOCK9_p.T891A
TTTGATCTGCTCTCATCAGCACGA	GCCaGGCTGCGCTGCTCGG	GTGTTGCCAGGCTGCGCTGCTCGGAGGAAC	CELSR1_p.001
TTTGGCTCATCGTCACACTCTCAG	CCCaCCGAGGAGGAGAGCT	GTGTTCCCACCGAGGAGGAGAGCTGGGAAT	PBLD_p.H257R
TTTGTGATATCACTCATCATGTCT	AGCaGGTTAGTGGCAGTGG	GTGTGAGCAGGTTAGTGGCAGTGGGGGCAG	NEURL4_p.Q1286R
TTTGTGCACACACTATATCATAGT	CCAGaGGACCTGGAGAGCA	GTGTCCCAGAGGACCTGGAGAGCAGGGAGG	RP13-395E19.1_p.E424G
TTTGATCACTGTCACACATCAGAC	AAGACaACGACACATAGCT	GTGTCAAGACAACGACACATAGCTGGGTGT	FOXO1_p.T647T
TTTGGCTCACACTCTACTATCGAC	AAGACaACGACACATAGCT	GTGTCAAGACAACGACACATAGCTGGGTGT	FOXO1_p.T647T
TTTGCTGTATCACTCACGCTACGT	GTGTaCAGCCAGGGGATGA	GTGGTGTGTACAGCCAGGGGATGATGGCGG	AKAP13_p.Y100C
TTTGGTCATGCACAGTCACACGAT	GCAaCGGGGCCGACGACTG	GTGGTGCAACGGGGCCGACGACTGTGGGGA	LRP1_p.N2586S
TTTGACGCACACTCATACATCGCG	TGAGAaCCAGTATGGCCAG	GTGGCTGAGAACCAGTATGGCCAGAGGGCC	MAG_p.N396S
TTTGGTACACAGCTCATATCTACG	GTGAaCACCATGGCCAGCT	GTGGCGTGAACACCATGGCCAGCTCGGCGG	CTSF_p.N475S
TTTGTGATCTCACACTCATATGTA	CTTCaCTGTGCGCAAGGCT	GTGGCCTTCACTGTGCGCAAGGCTGGGCGT	KIAA0317_p.T131A
TTTGCTGCTACATCGCACACTCGC	CCTGaGAGATGGCCCCGAA	GTGGCCCTGAGAGATGGCCCCGAAGGGAGC	IGSF9_p.E1047G
TTTGCGCACTCTATCACTCGCTCG	CCTCGaCTGAGGGTGCTCC	GTGGCCCTCGACTGAGGGTGCTCCTGGGCC	IYD_p.R246R
TTTGTACACGTCTACACGCTATCA	CCTCaGCAGCATCCTGAGC	GTGGCCCTCAGCAGCATCCTGAGCGGGATC	KCNG4_p.S437G
TTTGGTCACGCACACTCACACGCT	ACGTCaCTTCATCCAGCGC	GTGGCACGTCACTTCATCCAGCGCTGGAAC	PLD1_p.H696R
TTTGTAGTCTATCATCTACAGTCG	ACACaTGGGCACAATGGAT	GTGGCACACATGGGCACAATGGATGGGCGT	MST1R_p.M464V
TTTGATCATCATACACACGTCTAC	TGaGCGCTGGCGCGACGGC	GTGGATGAGCGCTGGCGCGACGGCTGGAAG	GFER_p.E193G
TTTGTAGCTCAGTCATCGTCACAG	TGaGCGCTGGCGCGACGGC	GTGGATGAGCGCTGGCGCGACGGCTGGAAG	GFER_p.E193G
TTTGACTGTCACATCACTCATACG	AAAGAaCGGCAGTAAATAC	GTGGAAAAGAACGGCAGTAAATACGGGCCC	FGFR2_p.N208S
TTTGACATCAGATCACACTATCAG	AAAGAaCGGCAGTAAATAC	GTGGAAAAGAACGGCAGTAAATACGGGCCC	FGFR2_p.N208S
TTTGAGTCACACGCTACTCGCTCT	GGAGaGTGAGCGGGCAGAG	GTGCTGGAGAGTGAGCGGGCAGAGCGGCTA	MYO18B_p.S1462G
TTTGCAGCATCGCTACACTCAGCG	GAaCTGCTCTGGACATATG	GTGCTGAACTGCTCTGGACATATGAGGGCC	HIF3A_p.N139S
TTTGTCTGCTCATATCAGTACATC	CTATaTTGATCCCCGGATG	GTGCTCTATATTGATCCCCGGATGAGGATC	MORC2_p.I187V
TTTGTACTACTACAGCTACTATAT	CGaAGATTGGGAGGTGAGC	GTGCTCGAAGATTGGGAGGTGAGCAGGGCA	GGT1_p.K52E
TTTGACACTCTATCTCACTATAGT	CGaAGATTGGGAGGTGAGC	GTGCTCGAAGATTGGGAGGTGAGCAGGGCA	GGT1_p.K52E
TTTGACACATACATATATCTCTCG	CACCaCTGCGTTGTGGAGG	GTGCCCACCACTGCGTTGTGGAGGTGGAAA	KLHL14_p.H365R
TTTGATGCTCTACTACGCACGTAT	CTGCCaGGCGGGCATCTCG	GTGCACTGCCAGGCGGGCATCTCGCGGTCG	DUSP4_p.Q190R
TTTGCATCATGTACACACTACTGT	CGGGTaCCCAGTCCTGGCC	GTGCACGGGTACCCAGTCCTGGCCTGGCAC	FDPS_p.Y39C
TTTGTCGTACTCTACTCGTCTATC	AGCaAGCGGAAAAGGGAGC	GTGAGAGCAAGCGGAAAAGGGAGCTGGTGA	HAND1_p.K176E
TTTGTACTATCTATACTCTACTCG	AGCaAGCGGAAAAGGGAGC	GTGAGAGCAAGCGGAAAAGGGAGCTGGTGA	HAND1_p.K176E
TTTGTGCTACATCTAGACACACGA	CTCaTGGGCAAGACCATGA	GTGACCTCATGGGCAAGACCATGACGGAGG	NAV1_p.M396V
TTTGGTCATGCTCACACTGTACTA	CCTCaAGACCAGCTTGCAG	GTGACCCTCAAGACCAGCTTGCAGTGGCTT	PRKAA2_p.Q317R
TTTGAGTCATCTAGTCACTACTAG	GAAGaGGTGGACATTGACT	GTGAAGAAGAGGTGGACATTGACTTGGATG	TRPM3_p.E478G
TTTGGACATCACATCACTCTATGA	ATTaCAGACTCTCAGACTG	GTGAAATTACAGACTCTCAGACTGAGGATA	AGGF1_p.T374A
TTTGTATCGCACACACTACTCAGT	AAaCCAGGTGAGTGGAATC	GTGAAAAACCAGGTGAGTGGAATCAGGGCC	C20ORF114_p.N198S
TTTGGTCTCTGCTACACTGCACAG	GTTaCAAGGACAGATGGGA	GTCTGGTTACAAGGACAGATGGGATGGTTG	ASXL1_p.T1054A
TTTGCAGTATATCACAGCTACACT	GTTaCAAGGACAGATGGGA	GTCTGGTTACAAGGACAGATGGGATGGTTG	ASXL1_p.T1054A
TTTGCAGCACACTGCACAGCTCTA	CTGTaCACGCCCCCGAGCT	GTCTCCTGTACACGCCCCCGAGCTGGGAAG	THAP10_p.T131A
TTTGCACTCGATCTACACATCTAC	CTGGCTTGACACGACCGTT	GTCGTCTGGCTTGACACGACCGTTAGGTCA	NT_nontargetX
TTTGTGATCATATATCTATCAGAT	CCCAaCTCCCAGCCTTGGC	GTCGCCCCAACTCCCAGCCTTGGCAGGCCG	KLK9_p.N32S
TTTGTATCTACATATCACACAGCG	AGGTaCACACTGACGGAGG	GTCGCAGGTACACACTGACGGAGGGGGACT	C19ORF26_p.Y147C
TTTGACATCAGCGTCACTACATCG	GGGaGAGACCGGCGCACAG	GTCCTGGGAGAGACCGGCGCACAGAGGAAG	TP53_p.R280G
TTTGCATCTATATCTATCACACTC	GGGaGAGACCGGCGCACAG	GTCCTGGGAGAGACCGGCGCACAGAGGAAG	TP53_p.R280G
TTTGCTCACACTCGCACTACTCGA	TGACGaGAAGTTATTACCG	GTCCGTGACGAGAAGTTATTACCGAGGCGC	RAB4A_p.R80G
TTTGCATCATCAGCTACTATCACT	TCGACAGTTCGTCCCGAGC	GTCCCTCGACAGTTCGTCCCGAGCAGGGCG	NT_nontargetX
TTTGGTCACATCACATCTGCTAGT	TCTaCAAATTCAGTGAAAG	GTCCATCTACAAATTCAGTGAAAGAGGTAT	GPBP1_p.T263A
TTTGAGCTCACTCTACTCTAGTCT	CTCaAGGAACAGTATGCTC	GTCCACTCAAGGAACAGTATGCTCAGGTAG	PMVK_p.K48E
TTTGCTCTACACTACACACGATAC	CTCaAGGAACAGTATGCTC	GTCCACTCAAGGAACAGTATGCTCAGGTAG	PMVK_p.K48E
TTTGCATATAGCTCATACATCGTC	CAGCaGCTGCACAGATGCG	GTCCACAGCAGCTGCACAGATGCGAGGCTC	GPR113_p.S278G
TTTGCGCTCATATCTACACACGAG	AAaCCACAGCGGGGAAGAC	GTCCAAAACCACAGCGGGGAAGACAGGGGA	KATNAL2_p.T60A
TTTGTGCTACTATCATCGCACACA	AAaCCACAGCGGGGAAGAC	GTCCAAAACCACAGCGGGGAAGACAGGGGA	KATNAL2_p.T60A
TTTGTATCTATATCTCACACGTCT	TGAGAaTGGGACGGACACT	GTCATTGAGAATGGGACGGACACTGGGCTG	AQP8_p.N59S
TTTGTCTACATATCGTCACTCTAC	TGAGAaTGGGACGGACACT	GTCATTGAGAATGGGACGGACACTGGGCTG	AQP8_p.N59S
TTTGCTCGCTCTCATCAGTCACTA	TCTGGaGGTGGGCCCAGGG	GTCATTCTGGAGGTGGGCCCAGGGCGGGCA	DCAF15_p.E480G
TTTGTCTCATACACAGCACTATAT	TCTGGaGGTGGGCCCAGGG	GTCATTCTGGAGGTGGGCCCAGGGCGGGCA	DCAF15_p.E480G
TTTGCGTCACTCACACTCTGTCGC	CTGCCaAGCCCAGCACCAA	GTCACCTGCCAAGCCCAGCACCAATGGCAC	EPN1_p.K385E
TTTGTCATAGTACATCACACGTAC	ATCaTTCTGGATTTGGACA	GTATAATCATTCTGGATTTGGACAGGGAAG	FAM98A_p.H507R
TTTGTCAGCACATCACAGACACGC	ATCaTTCTGGATTTGGACA	GTATAATCATTCTGGATTTGGACAGGGAAG	FAM98A_p.H507R
TTTGAGCACTCAGTCTCTATCGAC	CTCaGGTTTTGGCCGTGAT	GTAGGCTCAGGTTTTGGCCGTGATGGGTCA	TMTC1_p.Q617R
TTTGCAGCACTACTCAGCATCTCT	AGTaGTGGCACGGATCTGA	GTAGCAGTAGTGGCACGGATCTGACGGGTG	SPAG9_p.S1230G
TTTGAGCTCTAGCTCTCACTGCTC	AGTaGTGGCACGGATCTGA	GTAGCAGTAGTGGCACGGATCTGACGGGTG	SPAG9_p.S1230G
TTTGCGTCATCAGCACACACGTAT	TGAaGGTGGGGTTCAGGTC	GTACATGAAGGTGGGGTTCAGGTCTGGGTC	ABCC11_p.K1116R
TTTGACTACACTGCACTCACACGT	TCCCCaCCGCAGCTGCGTT	GTACATCCCCACCGCAGCTGCGTTTGGCGG	SEC61A2_p.T419A
TTTGCACACGCACACACTCATACA	TGCaTTGATGGAAAAAAAG	GTAAATGCATTGATGGAAAAAAAGTGGGTA	ALG8_p.I128V
TTTGCACATATCAGTACATCTACT	CTGaCCCTCTCCCTGTCTG	GTAAACTGACCCTCTCCCTGTCTGTGGCAG	PURG_p.T106A
TTTGTCTACAGACACACGTACTCA	ACCaAAGCAGGAGTGACAC	GGTTTACCAAAGCAGGAGTGACACAGGACC	TEX35_p.K45E
TTTGGTCTACTGCACTCGTCACGT	CTGaTGAAAAGTTATGATC	GGTTCCTGATGAAAAGTTATGATCAGGTGC	ACOX1_p.M436V
TTTGCTCATCATCTGACTACTATC	ATGaTCCTGCTCTGAGGGG	GGTTAATGATCCTGCTCTGAGGGGAGGCAA	NCOA2_p.D1434G
TTTGGCGTACTCACACATATCACA	GGAGTaCACAGTGCATGTC	GGTGTGGAGTACACAGTGCATGTCTGGGCC	TNN_p.Y596C
TTTGTCTCTCTACACACAGTACTA	CTACGaCAGTCAATGTGGA	GGTGTCTACGACAGTCAATGTGGATGGCCA	EBF1_p.T218A
TTTGCATGCTATCTATCGTCACAG	CCCaAGGCAGGAAGATGGG	GGTGTCCCAAGGCAGGAAGATGGGTGGCAC	CYP2A7_p.001
TTTGTGACTCTCATACACATACTC	GACaCACCGAAAGGGTCTC	GGTGGGACACACCGAAAGGGTCTCTGGCTT	GEMIN5_p.H63R
TTTGAGACACACTATCATATCGTC	GACaCACCGAAAGGGTCTC	GGTGGGACACACCGAAAGGGTCTCTGGCTT	GEMIN5_p.H63R
TTTGCACATCGCACACACACTATA	AAGaTGACGAAGTGGTGAG	GGTGGAAGATGACGAAGTGGTGAGTGGCCT	GNAT2_p.D237G
TTTGTAGTCACTCACTACTCAGCA	AAGaTGACGAAGTGGTGAG	GGTGGAAGATGACGAAGTGGTGAGTGGCCT	GNAT2_p.D237G
TTTGCTCATCAGTCACACTACTAC	TGGTCaCTGCTGCCCGCCC	GGTGCTGGTCACTGCTGCCCGCCCTGGCTT	FAM171A2_p.T96fs*48
TTTGCACATCTAGTCACTCTACGT	TACaTTAAGGAGCTTCCAA	GGTGCTACATTAAGGAGCTTCCAAAGGGCT	DBH_p.I234V
TTTGAGCACTAGTCACTCACTGCT	GCTaCGAGGACGTGGCACG	GGTGCGCTACGAGGACGTGGCACGCGGGCC	CHST3_p.Y371C
TTTGTCACTCACTCGCACATCGCA	CCAGCaGTCTGTCCACTGC	GGTGCCCAGCAGTCTGTCCACTGCAGGGAT	MCTP2_p.S81G
TTTGACAGCACTACTCACACTAGT	CCaCTGCCCCTGCAGCTCC	GGTGCCCACTGCCCCTGCAGCTCCTGGCCC	TRRAP_p.T489A
TTTGCGACTCATCTCTACGCTACT	AGCaGCAGAAGCTGAAGGT	GGTGCAGCAGCAGAAGCTGAAGGTGGGGCA	NUMA1_p.Q1569R
TTTGGTCTATCTACACTGCTCTAG	GGGGGaCCAGCCCCTCTCA	GGTGAGGGGGACCAGCCCCTCTCAGGGTAT	SH2B1_p.D519G
TTTGACATACTCGTCATATACTAC	CGGCCaAGGTGACCGAGAG	GGTGACGGCCAAGGTGACCGAGAGCGGCGG	PPIC_p.K39E
TTTGATACTACAGCATCAGTCTAC	ACGaGGTGGTCTTCAGCCC	GGTGAACGAGGTGGTCTTCAGCCCCGGGGA	WDR90_p.E1440G
TTTGTACACATGCACATACATATC	GCGAGaAGGTGCAGAGGAA	GGTCTGCGAGAAGGTGCAGAGGAAAGGGAC	TFDP1_p.K126E
TTTGTATCACAGCTCTGCTCTGTA	GCACCaAGCGCAGCAACAC	GGTCTGCACCAAGCGCAGCAACACGGGAGG	NOVA2_p.K23E
TTTGCATGCACTACTACACACTGA	GCACCaAGCGCAGCAACAC	GGTCTGCACCAAGCGCAGCAACACGGGAGG	NOVA2_p.K23E
TTTGATATACACATACTACACGTC	CCCCaGGGAGGGGGCCAGG	GGTCTCCCCAGGGAGGGGGCCAGGGGGCAC	C1ORF127_p.R467G
TTTGTATGCACACTCATGCTCTAT	GACAaCAAGCTCAAGACCG	GGTCGGACAACAAGCTCAAGACCGAGGTGT	GPR37L1_p.N453S
TTTGATATCAGCTATCATCTACTG	GACAaCAAGCTCAAGACCG	GGTCGGACAACAAGCTCAAGACCGAGGTGT	GPR37L1_p.N453S
TTTGCTACTACAGACTCTACACGT	GCCGGGACCGTTAGGGAAT	GGTCCGCCGGGACCGTTAGGGAATAGGATA	NT_nontargetX
TTTGTGATCACACTGTCTATCACG	CCaTGGGCTTCACGGGGTT	GGTCACCATGGGCTTCACGGGGTTCGGTGA	WDR70_p.M25V
TTTGATCTATCTGCATATCACTCG	AAGaGCTGTCGGTCATTGA	GGTCAAAGAGCTGTCGGTCATTGATGGCCG	DAAM2_p.E669G
TTTGACATACATACTCGCTCTATC	TTTTCaTGGTAGAGATGAG	GGTACTTTTCATGGTAGAGATGAGCGGAAT	C1ORF9_p.H399R
TTTGTCATACATCAGCACACTAGA	TATaACTTCAAGTGGTAAG	GGTACTATAACTTCAAGTGGTAAGTGGATT	LRMP_p.I42M
TTTGGAGCTCGCACATCGCTCTAG	CGCTaCCCACGGCCAGCCT	GGTACCGCTACCCACGGCCAGCCTCGGTGC	GYS1_p.Y636C
TTTGGATCAGCTCACTCTGTCACG	CCAGGaGCCTTTCAAAGTG	GGTAACCAGGAGCCTTTCAAAGTGCGGCTG	SNTG1_p.E23G
TTTGCTCGAGACACATCATACATA	CCAaAGGAGCTTCAAAGAG	GGGTTCCAAAGGAGCTTCAAAGAGTGGGCT	MPPED2_p.K225E
TTTGTGACTCAGCTCGCTCATCGC	TGTCGGATTCCGCCGCTTA	GGGTGTGTCGGATTCCGCCGCTTAAGGTCA	NT_nontargetX
TTTGACTAGCACATCTATCTCATA	TGGCaGTGTGGTGGCAAAT	GGGTGTGGCAGTGTGGTGGCAAATTGGAGA	 POC1B-GALNT4_p.Q175R
TTTGACATCATGCTACATACGCTC	GAGGaGTTGGCGGTGGAAG	GGGTGGAGGAGTTGGCGGTGGAAGAGGAAG	UBR4_p.E1639G
TTTGAGAGCACTCATCGCTCGCTA	GAGGaGTTGGCGGTGGAAG	GGGTGGAGGAGTTGGCGGTGGAAGAGGAAG	UBR4_p.E1639G
TTTGAGACAGCTACACATCTACTC	CCCaTCGCCATCCTCATCA	GGGTGCCCATCGCCATCCTCATCATGGTGC	SLC4A2_p.I942V
TTTGTACATACATCACTGACTACT	GCCaCGGAGCTCACCCACG	GGGGTGCCACGGAGCTCACCCACGAGGACT	PSMC3_p.T413A
TTTGGTCTATACTATCATCGTATA	GTAaGCAGCTGCCGCCTGC	GGGGGGTAAGCAGCTGCCGCCTGCGGGCAG	TMEM200C_p.K87R
TTTGGACATCTCTGCACAGTCTCT	GTAaGCAGCTGCCGCCTGC	GGGGGGTAAGCAGCTGCCGCCTGCGGGCAG	TMEM200C_p.K87R
TTTGTCTCACACTCTACTCTCATC	ATGGGaAAAAAAATGGATC	GGGGGATGGGAAAAAAAATGGATCTGGATG	TNRC6C_p.K613E
TTTGCAGCTATCTCGCTCTCTAGT	TGGCaGCAGATGTTCAAGG	GGGGCTGGCAGCAGATGTTCAAGGTGGAAC	MR1_p.Q92R
TTTGTCTCTCGCTCTCAGTCATAC	GGTaCACACCTCTGCCCTT	GGGGCGGTACACACCTCTGCCCTTGGGCGG	GAS2L2_p.Y587C
TTTGTGTCTCACAGTCTCTATCGC	CTGCCaCTGCACCCCTGGC	GGGGCCTGCCACTGCACCCCTGGCTGGACT	MEGF11_p.H651R
TTTGGTCTACTCTACAGCTCATGC	CCTCaAGATCTGGGACCTT	GGGGCCCTCAAGATCTGGGACCTTCGGCAG	GRWD1_p.K333E
TTTGTCTCATGCACACTCTAGCAT	GGTGGaTGCAGCCCAGGCC	GGGCTGGTGGATGCAGCCCAGGCCCGGCCC	AOC3_p.D85G
TTTGATCAGCTCACGTATCTACGT	GGAGAaGCTCTTCCAGGCC	GGGCTGGAGAAGCTCTTCCAGGCCCGGAAG	SPATA20_p.K503R
TTTGGTCTCAGTCATCACGTCTGA	TTCaTGAGCAGCAAGCCAT	GGGCCTTCATGAGCAGCAAGCCATCGGCGC	GRIK3_p.M711V
TTTGATCTATCTAGTCAGCACGTC	TCAGCaAGGTCAAGGAGGT	GGGCCTCAGCAAGGTCAAGGAGGTGGGTAC	PKD1_p.K4145E
TTTGTACACATCTCGCTCGCTCAC	TCAACCGACCGTATGGTCA	GGGCCTCAACCGACCGTATGGTCAAGGACC	NT_nontargetX
TTTGATCACACACTATCTACTAGA	ATGaGGTGAGCTGGCGGCC	GGGCCATGAGGTGAGCTGGCGGCCAGGACC	ELF3_p.R334G
TTTGCTCTCACTCTCGCTCGATAC	ATGaGGTGAGCTGGCGGCC	GGGCCATGAGGTGAGCTGGCGGCCAGGACC	ELF3_p.R334G
TTTGTCAGTCACACATCTCTGCAT	ACAaCCCGCTCTAGCTTGA	GGGCCACAACCCGCTCTAGCTTGAAGGCAC	KHDRBS2_p.T325A
TTTGTGTCACGATACTCACATCGA	AAGaGGGCCAGCTGAGGTA	GGGCCAAGAGGGCCAGCTGAGGTAAGGGCC	HEYL_p.E23G
TTTGTCGTATCTACATCTCTGATC	GGGaTGGACAACCATTTGG	GGGCAGGGATGGACAACCATTTGGAGGAGC	DBNDD2_p.M192V
TTTGGATACATCTACTATGCACAG	GCAGCaGCTCGGGCCCCAA	GGGCAGCAGCAGCTCGGGCCCCAAGGGGAA	DCLK2_p.S36G
TTTGCACTGATACATCTCTCACTA	AGCaGCCAGGACAGCAGCA	GGGCAAGCAGCCAGGACAGCAGCATGGATC	SLC4A5_p.S79G
TTTGGACGCACATCTACATCGCGT	ACCCCaAGGTCAAGGCCCA	GGGCAACCCCAAGGTCAAGGCCCATGGCAA	HBE1_p.K60E
TTTGACATACACTCATATCAGCAG	GTCaTGCTGTACAGGGCTC	GGGATGTCATGCTGTACAGGGCTCTGGGTG	WDR6_p.M680V
TTTGTATAGTCTCAGCTCTCTATC	CAGCaCCTCACGCCCACCT	GGGAGCAGCACCTCACGCCCACCTCGGCCG	ONECUT1_p.H233R
TTTGACTCATCATATACTGCTATC	AGTTaTGAGGACCCACCCC	GGGAGAGTTATGAGGACCCACCCCAGGTGA	SNCB_p.Y119C
TTTGCTCTGTCATCACTGTCACTA	GGCCTaTTCCCTGGGTGAA	GGGACGGCCTATTCCCTGGGTGAAGGGGGC	NPR2_p.I425V
TTTGTGACACACTCGCTCTACTAT	CTGTaCTTCTCCCGGGTCC	GGGACCTGTACTTCTCCCGGGTCCAGGTGT	SAG_p.Y88C
TTTGGATCTCACTACTACTCTCAT	CGCCaCCCCGCAGGTACGG	GGGACCGCCACCCCGCAGGTACGGGGGCGG	SRSF2_p.P106P
TTTGTATGTACACTACTACACAGA	CGCCaCCCCGCAGGTACGG	GGGACCGCCACCCCGCAGGTACGGGGGCGG	SRSF2_p.P106P
TTTGGTATACATACATACTCTCTA	ACTaCCTGTGCAACGCCTG	GGGACACTACCTGTGCAACGCCTGCGGGCT	GATA3_p.Y283C
TTTGGACTCTACATATATCTCGCT	ACTaCCTGTGCAACGCCTG	GGGACACTACCTGTGCAACGCCTGCGGGCT	GATA3_p.Y283C
TTTGATCACTCACTACTCACAGTA	CGGaGGACAGCGAGGAGGA	GGCTTCGGAGGACAGCGAGGAGGAGGGTCT	SBK2_p.E17G
TTTGCTGTATACACTCACGTCTAT	GAGTaCAGTGGCACCATCT	GGCTGGAGTACAGTGGCACCATCTTGGCTC	SYT14_p.Y36C
TTTGGCACTCATCTCTATGCATAC	CGGCaGCAGCAGCGGGCCC	GGCTGCGGCAGCAGCAGCGGGCCCTGGAAG	TXNDC11_p.Q840R
TTTGGCTACACTACTGCTATCACT	CAGGaCGCCAGGCGGCGGC	GGCTGCAGGACGCCAGGCGGCGGCAGGAGC	PLEC_p.D1203G
TTTGCTCACTGCGTCACACACTCG	CAGGaCGCCAGGCGGCGGC	GGCTGCAGGACGCCAGGCGGCGGCAGGAGC	PLEC_p.D1203G
TTTGACACATCAGCTCACATATGC	CACaTCGGGTGTGATGAGG	GGCTGCACATCGGGTGTGATGAGGTGGGTA	HEXDC_p.I145V
TTTGTCATCGCTGCATCTACTATC	ACaGGTGCTCCTCACAGCC	GGCTGACAGGTGCTCCTCACAGCCTGGGGC	DDX27_p.R375G
TTTGCTGCACTACATATCACTATC	AAGTaTGAGCGGGCTGTGC	GGCTGAAGTATGAGCGGGCTGTGCGGGAGG	MYO18A_p.Y1375C
TTTGATCACATCATAGCTCTCGCA	AAGCCaGGGCAGCCCTCTG	GGCTCAAGCCAGGGCAGCCCTCTGTGGAAT	CLEC18B_p.R85G
TTTGAGTCACTCACTACTCTGTCG	TGCaAGGGCTGCTGGGCCC	GGCGTTGCAAGGGCTGCTGGGCCCAGGGAC	PEX6_p.Q146R
TTTGTGTCACGACACATCAGTCTC	GGCCTaCCCGGCCTTTCTG	GGCGTGGCCTACCCGGCCTTTCTGGGGCCC	SPSB4_p.Y161C
TTTGCTGATCACACGTCTACTCAT	GGCTGaGGGCGCAGGTGCG	GGCGGGGCTGAGGGCGCAGGTGCGGGGCAG	KISS1_p.*139W
TTTGATGATACTCTATATCTCGTA	GGaCGGCCCGTTCGGCCTG	GGCGGGGACGGCCCGTTCGGCCTGAGGAGC	TBX2_p.D414G
TTTGACGCACATCTACTAGCTCAC	GCACCaTGGGCTCCTGCTC	GGCGGGCACCATGGGCTCCTGCTCCGGCCG	NKAIN4_p.M1V
TTTGGCATGCTCTACATCAGTACT	CCACCaCTGCCCTGGCGGC	GGCGGCCACCACTGCCCTGGCGGCGGGCGG	AP5B1_p.T102A
TTTGGCACACACATCACTATCGTA	CCACCaCTGCCCTGGCGGC	GGCGGCCACCACTGCCCTGGCGGCGGGCGG	AP5B1_p.T102A
TTTGCGTACTCACTGCTACACTAC	CAGCaGCAAGAGAAAGGAG	GGCGGCAGCAGCAAGAGAAAGGAGAGGCAG	WIBG_p.Q100R
TTTGTAGCATCATCTCTCGCATAT	AAATaCGTCTTCCAGTGCA	GGCGGAAATACGTCTTCCAGTGCACGGACG	SLIT3_p.Y1497C
TTTGCTGATACACATATCACGATA	TTCCaCAGGGCCTGCCGCC	GGCGCTTCCACAGGGCCTGCCGCCTGGTGC	CYP4F12_p.H257R
TTTGTGCTCACTATACAGCATCTC	GCTaCAACCTCAGCCAGGG	GGCGCGCTACAACCTCAGCCAGGGCGGCTA	KCNK3_p.Y52C
TTTGAGATCATCTAGCTCACAGAT	GTGaTGGTGACAATGACTG	GGCCTGTGATGGTGACAATGACTGTGGGGA	LRP1B_p.D1026G
TTTGGTCTACATATACACACAGTC	GCTCaGCGAGGCAGAGGCC	GGCCTGCTCAGCGAGGCAGAGGCCCGGAGC	PITX3_p.S7G
TTTGTCACACACAGCACTCACTGC	GCGGCaAGGTCGCCTCTAC	GGCCTGCGGCAAGGTCGCCTCTACCGGCAG	KLHDC8A_p.Q232R
TTTGCGACTCTACTCACGTCACAC	GCGCaCGACCCGCATGTCC	GGCCTGCGCACGACCCGCATGTCCTGGCCC	PDE4A_p.T81A
TTTGCTCTGCATCTCACTCAGTAT	GCGCaCGACCCGCATGTCC	GGCCTGCGCACGACCCGCATGTCCTGGCCC	PDE4A_p.T81A
TTTGACTACTCTCACTCTCAGTAT	GGGaCCGCCAGCAGCTCGG	GGCCAGGGACCGCCAGCAGCTCGGGGGGCT	NCOR2_p.T1514A
TTTGATACACTGTATCACACTACT	CCTaCGAGCACTTCCACCG	GGCAGCCTACGAGCACTTCCACCGCGGCCA	PPL_p.Y732C
TTTGACATCATCATAGCTACTCGA	CCCaCAGGCGCACCCACAG	GGCAGCCCACAGGCGCACCCACAGCGGCGA	ZNF764_p.H333R
TTTGCACTGTCACGTCATATCACA	CCCaCAGGCGCACCCACAG	GGCAGCCCACAGGCGCACCCACAGCGGCGA	ZNF764_p.H333R
TTTGACTCTAGCATATACACTCTG	AAAaCaTGATCCGGTACAC	GGCAGAAAACATGATCCGGTACACGGGCAG	PLXNA4_p.M1624V
TTTGGAGTACACTCTATCTACTGT	TGAGCaTTCCCGACTCTCT	GGCACTGAGCATTCCCGACTCTCTGGGCCG	CAMTA2_p.I785V
TTTGCACTCATATACACTCATACT	AGAAaTGCAGAATGCTTAA	GGCAAAGAAATGCAGAATGCTTAAAGGCTG	CAPZA1_p.M283V
TTTGATACTGCACACATCACGCAT	AGAAaTGCAGAATGCTTAA	GGCAAAGAAATGCAGAATGCTTAAAGGCTG	CAPZA1_p.M283V
TTTGGACTCTCACGTCTACTCTAG	ATGGTaTGATGTCTGATTA	GGATTATGGTATGATGTCTGATTATGGCAC	CTNND1_p.M298V
TTTGCTCGCTACGTCTATCTCACT	ATGGTaTGATGTCTGATTA	GGATTATGGTATGATGTCTGATTATGGCAC	CTNND1_p.M298V
TTTGTCTACTACGACTCTCTATCT	ACAGTaCTCCCACCACCAA	GGATTACAGTACTCCCACCACCAATGGAAC	SRPR_p.T263A
TTTGTGACATCATCACTCTGTATA	TGCGGaCAACCTCAGCTAC	GGATGTGCGGACAACCTCAGCTACGGGCTC	WNT11_p.D159G
TTTGTCACTCATCACTCTGACACG	TGaCaGCCCAAGATACTAC	GGATGTGACAGCCCAAGATACTACCGGTAT	RAI14_p.T73A
TTTGGCTCTGCTCACATCATGCAC	CGGAaCCCCTGGGGCGAGG	GGATGCGGAACCCCTGGGGCGAGGTGGAGT	CAPN1_p.N296S
TTTGCTCTACATCACTCACTATGA	CGGAaCCCCTGGGGCGAGG	GGATGCGGAACCCCTGGGGCGAGGTGGAGT	CAPN1_p.N296S
TTTGCGTCACTAGACTCTATATCT	CGACCaGGACCCTGGGGAA	GGATGCGACCAGGACCCTGGGGAAAGGTGA	GSTO2_p.R7G
TTTGCTCAGCACACTCGCTCTAGT	ATGTaCTGGACTGTTGTTG	GGATGATGTACTGGACTGTTGTTGGGGATC	LRP1B_p.Y4042C
TTTGACGCTCACATCATCTCTCAG	GTATaTTTGAACCTGCTAA	GGATAGTATATTTGAACCTGCTAAGGGAGG	ADAR_p.I939M
TTTGCAGCTCGCTACACTCATACG	TCCTGaGGACACCATTCGG	GGAGTTCCTGAGGACACCATTCGGGGGCCG	FLYWCH1_p.R117G
TTTGACACTCTGTACACTCGCATA	GAAGaCCATTGAAGCCAAC	GGAGTGAAGACCATTGAAGCCAACGGGCGG	CRMP1_p.T171A
TTTGCTACACTATGCATCATACAC	GAAGaCCATTGAAGCCAAC	GGAGTGAAGACCATTGAAGCCAACGGGCGG	CRMP1_p.T171A
TTTGCTCACACACACGATATCATA	TGGaGCTGCTCTACGAGGT	GGAGGTGGAGCTGCTCTACGAGGTAGGCAG	FAM180A_p.E55G
TTTGCAGTCTATCATCTCGCTACT	TGGaCATTATCCAGGCTCG	GGAGGTGGACATTATCCAGGCTCGGGGACT	RIMS4_p.D133G
TTTGCTAGATACATCATCATATCT	TGGaCATTATCCAGGCTCG	GGAGGTGGACATTATCCAGGCTCGGGGACT	RIMS4_p.D133G
TTTGACTATATCTACTCGTATCTA	TCTTCaCCGCTGAGGGCAA	GGAGGTCTTCACCGCTGAGGGCAAAGGAAG	SMYD1_p.T13A
TTTGTCATAGCTCACTACAGCACG	GTTTaTTATCCAGTGGAAC	GGAGGGTTTATTATCCAGTGGAACGGGAAC	ADAMTS12_p.I758V
TTTGGATCTGCATCACTCATCACA	GTTTaTTATCCAGTGGAAC	GGAGGGTTTATTATCCAGTGGAACGGGAAC	ADAMTS12_p.I758V
TTTGTCACTCTGCACATCTCACAG	GCCaGGTGCCCGAGGGAGC	GGAGGGCCAGGTGCCCGAGGGAGCCGGCCT	AHNAK2_p.Q1895R
TTTGGCACACAGTCACTCATCATC	CTGaTCGACCAGAGCTTCC	GGAGGCTGATCGACCAGAGCTTCCTGGCCT	TBC1D24_p.I169V
TTTGGATGCTCTCTACACTCTCGT	CGATTaCAGCCGACCCCCG	GGAGGCGATTACAGCCGACCCCCGAGGTGG	RASAL1_p.T95A
TTTGCTCACACTGTACATATCTAG	CCTTCaGCCTGGCATCCGC	GGAGGCCTTCAGCCTGGCATCCGCGGGCCA	C11ORF41_p.S1563G
TTTGTGATCACGCACTCTCTCTAC	CCTTCaGCCTGGCATCCGC	GGAGGCCTTCAGCCTGGCATCCGCGGGCCA	C11ORF41_p.S1563G
TTTGCTACATGCACTACACTCTAC	CCAaAAGTGGTTACCAGGC	GGAGGCCAAAAGTGGTTACCAGGCTGGTAA	PCDH1_p.K883R
TTTGCGACACTCATCTCTCTAGTC	CCAaAAGTGGTTACCAGGC	GGAGGCCAAAAGTGGTTACCAGGCTGGTAA	PCDH1_p.K883R
TTTGGTCTCATCACAGACTCACTA	AACCaTGGTAACCTATGGG	GGAGGAACCATGGTAACCTATGGGGGGATG	MECR_p.H169R
TTTGAGCACAGCATCGCTCACATA	AACCaTGGTAACCTATGGG	GGAGGAACCATGGTAACCTATGGGGGGATG	MECR_p.H169R
TTTGGCTCAGATCTCTACACTACG	TGGaCCTCCGGGGTGAGTC	GGAGCTGGACCTCCGGGGTGAGTCCGGGGG	SNRPA1_p.D25G
TTTGACTCATCACTCAGTCACATC	TGCaGCGCCTGCAGATGGC	GGAGCTGCAGCGCCTGCAGATGGCTGGGGG	MLLT6_p.Q981R
TTTGATGCATCACATCTACTCTGA	TAGaGGCCTCAAAGAGCTT	GGAGCTAGAGGCCTCAAAGAGCTTTGGGCC	MICAL3_p.E982G
TTTGCGTCTAGTCTACTCATCTGT	GGTaTGGCCCAGAAAACCT	GGAGCGGTATGGCCCAGAAAACCTGGGAAC	COPS5_p.M8V
TTTGAGTGTCACACATCACAGCAT	GGTaTGGCCCAGAAAACCT	GGAGCGGTATGGCCCAGAAAACCTGGGAAC	COPS5_p.M8V
TTTGATAGACTCTCTACACAGTCG	AGGaGAAAGACGCCCCTCT	GGAGCAGGAGAAAGACGCCCCTCTTGGGGG	STBD1_p.E39G
TTTGACACATCACTCGCTCTCATA	AGGaGAAAGACGCCCCTCT	GGAGCAGGAGAAAGACGCCCCTCTTGGGGG	STBD1_p.E39G
TTTGGCTATCTACATCACACTCTA	AGATaCAGAGGGTTCTCAG	GGAGCAGATACAGAGGGTTCTCAGTGGATA	XPO4_p.T645A
TTTGATACACACATATCTCACGCA	TCGaGAGGACAGCGTTTGT	GGAGATCGAGAGGACAGCGTTTGTGGGGTT	EBF1_p.E85G
TTTGGTCACACAGCACTATGCACA	TCGaGAGGACAGCGTTTGT	GGAGATCGAGAGGACAGCGTTTGTGGGGTT	EBF1_p.E85G
TTTGATATATCAGCTACGCACGTC	TCCaTCTCAAAGCATGAAA	GGAGATCCATCTCAAAGCATGAAAAGGCCA	HMGB4_p.I52V
TTTGTATAGATCACACACACATCG	CAGCaTGTTTATAAAACTG	GGAGACAGCATGTTTATAAAACTGAGGACA	CUBN_p.M1255V
TTTGCTACATACATATATCTACAC	CCAGaTTATATCGCCCCAG	GGACTCCAGATTATATCGCCCCAGAGGTAG	PRKCA_p.D503G
TTTGGATCTCATCAGCACACTACT	TGGTaCGTGAAGGCCATGG	GGACCTGGTACGTGAAGGCCATGGTGGTCG	OBP2A_p.Y30C
TTTGTACAGCACTCGATATCATCA	ATCCaGTGTGCAAAAGGTA	GGACCATCCAGTGTGCAAAAGGTACGGCGG	C21ORF124_p.Q272R
TTTGATCTCTAGCACACTAGTCAG	ATCCaGTGTGCAAAAGGTA	GGACCATCCAGTGTGCAAAAGGTACGGCGG	C21ORF124_p.Q272R
TTTGTATCACGCACTACACTAGCT	AGTaCATCTGTAAATAGCC	GGACCAGTACATCTGTAAATAGCCCGGAGG	WNT5B_p.Y356C
TTTGGCTATACTCACACTGCTCTC	AGGGaCAATGGATTGGAGC	GGACCAGGGACAATGGATTGGAGCTGGATG	PXDNL_p.D366G
TTTGAGTCTACTCACACTACAGCT	AAGGaTGGAGAGGAGGTGG	GGACCAAGGATGGAGAGGAGGTGGTGGAGA	OBSL1_p.D934G
TTTGTACACTATCATCTAGCTCAC	TGAaGCAATATCAAGGCTC	GGACATGAAGCAATATCAAGGCTCCGGCGG	TMEM222_p.K35R
TTTGCATGCTCATATCACATATAC	GTGGGaCAGCAGCCTGGAA	GGACAGTGGGACAGCAGCCTGGAAGGGCCG	C22ORF31_p.T180A
TTTGTATATATCACATCACTATGT	GTGGGaCAGCAGCCTGGAA	GGACAGTGGGACAGCAGCCTGGAAGGGCCG	C22ORF31_p.T180A
TTTGGTCAGCATCTCACACTGTAC	GCCaaGTCTGTGACTTGCA	GGACAGCCAAGTCTGTGACTTGCACGGTCA	TP53_p.K120E
TTTGTGACACACAGCTACACTCGA	GCCaaGTCTGTGACTTGCA	GGACAGCCAAGTCTGTGACTTGCACGGTCA	TP53_p.K120E
TTTGTACACGTCACATCTCATATA	CCACCaCCATTCTGGCTGC	GGACACCACCACCATTCTGGCTGCCGGGGC	SGPP2_p.T279A
TTTGGTCACTCTGTCACACTGTCA	GTGaGCCCCCACAGTGGGG	GGAAGGTGAGCCCCCACAGTGGGGTGGTGG	FBLN1_p.S636G
TTTGCATGCGCTACACTCTACACT	GTGaGCCCCCACAGTGGGG	GGAAGGTGAGCCCCCACAGTGGGGTGGTGG	FBLN1_p.S636G
TTTGACATCATCGACACACTACAC	CTGTCaGCAAAGCCGGGCT	GGAAGCTGTCAGCAAAGCCGGGCTGGGGAT	DNAH10_p.S1823G
TTTGTCACATATCTACATCAGCGT	CCTaCGCCGTCCACCTTGA	GGAAGCCTACGCCGTCCACCTTGAAGGCAG	COL4A1_p.T1289A
TTTGCTGCATCTCGCACTCATATC	CCAGGaAAAGCTGGCCAAT	GGAAGCCAGGAAAAGCTGGCCAATGGGGAG	PCDH7_p.E1132G
TTTGCGCTCACACATCACTCATAC	TCCaGCAGGATATGGTAGA	GGAACTCCAGCAGGATATGGTAGAGGGAGA	SFPQ_p.P688P
TTTGCTACATCTACTCTCACACAC	CTaTGGAAAAGGTATGATT	GGAACCTATGGAAAAGGTATGATTAGGTCT	GNL3_p.M106V
TTTGTGCATATACTCAGTCTATCA	CGGaCAGCTGAGAGCCGTG	GGAACCGGACAGCTGAGAGCCGTGGGGCTG	RPUSD1_p.D311G
TTTGATCTCGATACATCTCATAGC	CAGaCATCACGGTGATTGT	GGAACCAGACATCACGGTGATTGTGGGTGA	TMPPE_p.D239G
TTTGATCTCACATCACTCATACGA	CAGaAGATGTGGCTCAGGT	GGAACCAGAAGATGTGGCTCAGGTAGGCAG	MICALL1_p.E138G
TTTGAGTCACACGCTACGCTACAT	AGTCAaCGTCAGCCTGCCC	GGAACAGTCAACGTCAGCCTGCCCAGGTGG	OSBPL7_p.N622S
TTTGATCTACTACTATACTCGCTC	AGCAGaCGTGCACTTTGAG	GGAACAGCAGACGTGCACTTTGAGCGGAAG	THOC4_p.D150G
TTTGACTCATCTCTATCAGATCAG	ACACaGATCTACAAGGCCC	GGAACACACAGATCTACAAGGCCCAGGCAC	HLA-B_p.Q89R
TTTGCACTAGTCTACTCATCTATC	ACACaGATCTACAAGGCCC	GGAACACACAGATCTACAAGGCCCAGGCAC	HLA-B_p.Q89R
TTTGCTCAGCTCACAGTCTCATGC	TAATCCGGAAACGCTCGAC	GGAAATAATCCGGAAACGCTCGACAGGTCT	NT_nontargetX
TTTGTAGCACTCAGCACAGTACAC	AAGGCaACTCGGCGGTGAT	GGAAAAAGGCAACTCGGCGGTGATGGGCGG	PTGDR_p.N18D
TTTGTAGATCACACTCTACTACAC	CCCCaGTATGCAGCCTGGC	GCTTTCCCCAGTATGCAGCCTGGCTGGTGC	NKAIN1_p.001
TTTGCTCACTCTACACTATCTGTC	ACaTTTCACAGCTACAGAA	GCTTTACATTTCACAGCTACAGAAAGGAAA	BRMS1L_p.I310V
TTTGCTCACGTCACATACACTCGA	TCAaCTTGGCCGATCACAA	GCTTGTCAACTTGGCCGATCACAACGGGAA	KANK4_p.N818S
TTTGGATCTCACACAGCTCTACAC	CGCGTaAGTCTGCGGGACC	GCTTGCGCGTAAGTCTGCGGGACCCGGGTA	GLB1_p.001
TTTGCACTACGTCACACATATCTG	CGCGTaAGTCTGCGGGACC	GCTTGCGCGTAAGTCTGCGGGACCCGGGTA	GLB1_p.001
TTTGCTATGTCACAGCTACGTATA	ATGGCGCTTCAGTCGTCGG	GCTTGATGGCGCTTCAGTCGTCGGAGGCCT	NT_nontargetX
TTTGTCTCTCGCTACATCATCTAG	GTGGaCAGCGACGGCGAGC	GCTTCGTGGACAGCGACGGCGAGCTGGCTC	CILP2_p.D629G
TTTGGTCACGACACATCACACTAC	GTGGaCAGCGACGGCGAGC	GCTTCGTGGACAGCGACGGCGAGCTGGCTC	CILP2_p.D629G
TTTGGCACGTACTACATCATCGAT	GGaGTGGCCGAGGGCTGGA	GCTTCGGAGTGGCCGAGGGCTGGATGGGGC	ALDH16A1_p.S332G
TTTGTCGCACTACACTCTAGTCTA	GACTaCAGCACCTGCGTCC	GCTTCGACTACAGCACCTGCGTCCTGGCCA	TRIM50_p.Y334C
TTTGACTCTACTCTCACTCGCTCA	CGAAGaCCAGCTGAGGCAG	GCTTCCGAAGACCAGCTGAGGCAGAGGCTG	CCDC153_p.D60G
TTTGTACTACTACAGCATCTCAGC	GCTGCaCCGCGTCCATCAT	GCTGTGCTGCACCGCGTCCATCATGGGCCT	ADRA1A_p.T111A
TTTGTACATCACTCTCACATCTGA	CCTTGaGTGGTTTGCCGAG	GCTGTCCTTGAGTGGTTTGCCGAGCGGGTT	EHD3_p.E176G
TTTGCTACATCACTCACTAGCACT	AGTaCTGCAGACAGGTGGG	GCTGGAGTACTGCAGACAGGTGGGCGGGGC	APLP1_p.Y94C
TTTGTATCACACTAGACACTCATC	TGCaGCAGGCCCAGCAGGT	GCTGCTGCAGCAGGCCCAGCAGGTAGGCGG	JAKMIP1_p.Q789R
TTTGTCATACATATCACGCTATCT	GTTaTTTGGTTGGTGCCTG	GCTGCGTTATTTGGTTGGTGCCTGCGGACG	L2HGDH_p.Y7C
TTTGCAGACTCTCTATCATATCGT	CGAGaTGAAGACAGCAAAC	GCTGCCGAGATGAAGACAGCAAACAGGTGT	IL12RB1_p.D487G
TTTGGCAGCTACTACAGTCTATAG	CCTaTGATGACTGTGTGTT	GCTGCCCTATGATGACTGTGTGTTTGGAGG	NFKBIA_p.Y305C
TTTGGAGCACTCGCACATCATACT	CCGCaCATCCTGCTCCACA	GCTGCCCGCACATCCTGCTCCACAGGGCAG	CELSR3_p.T2707A
TTTGATGTACTACTATACTACAGC	CCAAGaGGCTGCTCAAGAA	GCTGCCCAAGAGGCTGCTCAAGAAGGGCAA	CHD5_p.R658G
TTTGAGTCAGCTCTCTATCGTCAC	AGaTGGCCCTGGAGTGGGC	GCTGCAGATGGCCCTGGAGTGGGCAGGCAG	CHRD_p.M381V
TTTGCATACATATCAGCACTCAGC	AGaTGGCCCTGGAGTGGGC	GCTGCAGATGGCCCTGGAGTGGGCAGGCAG	CHRD_p.M381V
TTTGGCTCGATACATACATCACAC	ACaTGAGCCTGGGTGAGCT	GCTGCACATGAGCCTGGGTGAGCTCGGCGA	CNTNAP1_p.M236V
TTTGTATCGCTCACTCGCTCGTCT	GAGCTaAATTAATTGAATG	GCTGAGAGCTAAATTAATTGAATGTGGCTG	ENY2_p.K36E
TTTGAGTCACTGCACACTCAGTAG	AGaCTCTGGCTGGCCACGA	GCTGAAGACTCTGGCTGGCCACGAAGGCAA	PRPF4_p.T487A
TTTGTATACTCACACTCTATGTAG	GTGaTCGGGACAATGACTG	GCTCTGTGATCGGGACAATGACTGCGGGGA	LRP2_p.D1291G
TTTGGTCACTCGTCTATCATCGCA	CCTaTAGCCTGCGGTTTGG	GCTCTCCTATAGCCTGCGGTTTGGGGGACA	ADAM20_p.Y113C
TTTGTCACGCACATCACACAGCAT	ACAaCTGCCGCTGCAAGCG	GCTCTACAACTGCCGCTGCAAGCGGGGTAT	GFRA1_p.N86S
TTTGCTACAGTCTATCATCTGCAT	CCAaCCAGCTTGAGGCCAC	GCTCGCCAACCAGCTTGAGGCCACTGGCGT	DHRS13_p.N213S
TTTGTCTCATATACTCACTATAGC	TGACCaGGCCAGGGGAGGG	GCTCCTGACCAGGCCAGGGGAGGGTGGCAC	PTPRM_p.R357G
TTTGATCACGTCTATATCACATGC	TACaCGGAGAAGGACAAGC	GCTCCTACACGGAGAAGGACAAGCAGGCGT	UPP1_p.T228A
TTTGTCTACTCTCATCGTCACATC	CACaGCCCCGGACGCGCCC	GCTCCCACAGCCCCGGACGCGCCCGGGTGC	FREM3_p.S133G
TTTGGCTCAGCACTCATCACTCTA	AGGaTCGCTGCCGCCGCCT	GCTCCAGGATCGCTGCCGCCGCCTGGGCTC	DHX16_p.D630G
TTTGACACTCAGCACTATCAGCAC	GAGGaCGAGGACGAGGGAG	GCTCAGAGGACGAGGACGAGGGAGTGGAGC	HIF3A_p.D528G
TTTGGTCTCATACTATCGCACGTC	CGGaCTGTGTGGTAAGATT	GCTCACGGACTGTGTGGTAAGATTTGGAAG	HNRNPA1_p.D42G
TTTGACATAGCGTCTACTACACAC	TCCTaTGATCAGCAAACTG	GCTATTCCTATGATCAGCAAACTGAGGTAC	SMC3_p.M609V
TTTGGCTATCACGTCACTCTACAC	TCCTaTGATCAGCAAACTG	GCTATTCCTATGATCAGCAAACTGAGGTAC	SMC3_p.M609V
TTTGAGATCATCGCTCTGCTCTCG	AATaTGGTATCTCTTAGAT	GCTAGAATATGGTATCTCTTAGATGGGAAA	MRPL13_p.I17M
TTTGACTCACTCTAGCTCTACACT	ATCaTGGACTGGAGGCTGA	GCTACATCATGGACTGGAGGCTGAAGGAGT	SLC43A2_p.M385V
TTTGTGCTCTATCGCTCTCAGTAC	GCTCCATCGCCGCGATAAT	GCTAAGCTCCATCGCCGCGATAATAGGTCC	NT_nontargetX
TTTGTGTCATCATCATACTCGTAT	ACATAaGATAATTCATACT	GCTAAACATAAGATAATTCATACTGGGAAG	ZNF729_p.K619R
TTTGAGCACATATACATCGCATAT	ACATAaGATAATTCATACT	GCTAAACATAAGATAATTCATACTGGGAAG	ZNF729_p.K619R
TTTGTCTACAGTCACTCTCAGCGC	ATGaTGAAGCTGCTCAGCT	GCGTTATGATGAAGCTGCTCAGCTCGGAGG	TTC12_p.M611V
TTTGTACTACTCATATCAGCACTA	GTGTaTGAGTATGTGAGCA	GCGTGGTGTATGAGTATGTGAGCACGGCAG	PREX1_p.Y857C
TTTGGTATCTCATCATCATCTATA	GCCaGGGTCAAGGCACGCA	GCGTGGCCAGGGTCAAGGCACGCAAGGTGC	GPR161_p.R102G
TTTGCAGACTCTACTACATACACT	CAaGCTGGAGCGCCGGCTG	GCGTGCAAGCTGGAGCGCCGGCTGCGGCGC	EFHD1_p.K9R
TTTGTATAGTCTCACATCGTCGAC	GCTGGaCCTGAGCTTCACG	GCGGTGCTGGACCTGAGCTTCACGGGGCTG	C22ORF36_p.D186G
TTTGTCATGACTCACTACACATGT	TGCCaAGGCTGATGCCCTC	GCGGGTGCCAAGGCTGATGCCCTCAGGGAA	ARHGAP44_p.K175E
TTTGGCTCTATCTACTATCACTGT	AAGaTGAATAAGGGCTGGC	GCGGGAAGATGAATAAGGGCTGGCTGGAGC	BAP1_p.M1V
TTTGCGTCTACACTCAGCTCACAC	AAGaTGAATAAGGGCTGGC	GCGGGAAGATGAATAAGGGCTGGCTGGAGC	BAP1_p.M1V
TTTGCTAGTCTATATCTCTCTACG	TGGCaCAGCATGTGCAGCC	GCGGCTGGCACAGCATGTGCAGCCTGGGTG	KLHL36_p.H486R
TTTGACACGTACTCACTACATCGA	TGGaGCTGGCCCGGGAGCT	GCGGCTGGAGCTGGCCCGGGAGCTGGGCGT	CHID1_p.E368G
TTTGCTCATCTCTGCGTCTACTCG	GCCaGCCCCCAGTTCGACC	GCGGCGCCAGCCCCCAGTTCGACCTGGACG	MAPK4_p.S534G
TTTGTATCGACACACACGCACATA	CCCaGGGGGGTGTGTTCCA	GCGGCCCCAGGGGGGTGTGTTCCAGGGAGA	OSBPL7_p.001
TTTGATCACACTCACATAGTCGTC	CACaCCTTCCCCTGCCAGC	GCGGCCACACCTTCCCCTGCCAGCTGGACA	ACTRT2_p.T203A
TTTGATCTGCTCTATCTGTACTAC	TTCaCGACCGAGGGAACAT	GCGGATTCACGACCGAGGGAACATTGGCAA	VAT1L_p.H368R
TTTGCTAGCTCACTCTCACACAGC	GGAGaGGAAAGGCCAGTTC	GCGCGGGAGAGGAAAGGCCAGTTCCGGGCG	ZFHX4_p.R2661G
TTTGTGTCTATCTCACTGTCATCT	ACGaCGCCGCCTACCTGGC	GCGCGACGACGCCGCCTACCTGGCGGGCCT	GAL3ST3_p.D220G
TTTGCATCTCATATCTCATAGTAC	ACGaCGCCGCCTACCTGGC	GCGCGACGACGCCGCCTACCTGGCGGGCCT	GAL3ST3_p.D220G
TTTGACTCGTCACTCTACGCACGA	GGCaGGGGGTACTGCGCGC	GCGCCGGCAGGGGGTACTGCGCGCCGGGCA	IGFBP7_p.R78G
TTTGATGTACACTCTCTCACTCAC	GAGGaGGCTTTCCTGCTGG	GCGCCGAGGAGGCTTTCCTGCTGGTGGCAA	DNAJC25-GNG10_p.E99G
TTTGACTACTCATACTCTAGCTAC	CCCaTCGTGCAGTGCGCCG	GCGCCCCCATCGTGCAGTGCGCCGTGGCCG	CPSF1_p.I646V
TTTGGTACACAGACTCACATATCT	AGTCAaCTTCATCAGCGCA	GCGCCAGTCAACTTCATCAGCGCAGGGCTC	TFIP11_p.N79S
TTTGTACTCATCTACACATCAGAT	CGCaGGCTGTGGAGCTGCG	GCGCACGCAGGCTGTGGAGCTGCGGGGGCA	PRIC285_p.Q120R
TTTGTCGCACATCATACATCGTCA	AGTaCTCGGTGTGGATCGG	GCGCAAGTACTCGGTGTGGATCGGTGGCTC	ACTG1_p.Y337C
TTTGCATCTGTCACACTCGTCTAT	GGaGCGCGCGGTAGAGCCT	GCGATGGAGCGCGCGGTAGAGCCTTGGGGC	ZNF48_p.E2G
TTTGCAGTATCATCACAGCTCACA	GAGCaGCGGCTGGCGCTGG	GCGAGGAGCAGCGGCTGGCGCTGGAGGCCC	FAM83G_p.Q31R
TTTGCACATATCAGACTCACACTA	CAATaGCAACAAGACCTGG	GCGAGCAATAGCAACAAGACCTGGAGGATG	CSF3R_p.S473G
TTTGACTCACTACATCGTCTATAT	AGAGCaTCCACGGCTCCGG	GCGACAGAGCATCCACGGCTCCGGCGGCCC	PCDHAC2_p.H13R
TTTGCATCTACTATCTACACGAGT	ACCaaCCCTGTCAATGGCA	GCGACACCAACCCTGTCAATGGCAAGGCCA	NOTCH1_p.N390D
TTTGGTCAGATCACATCTACAGTC	ACCaaCCCTGTCAATGGCA	GCGACACCAACCCTGTCAATGGCAAGGCCA	NOTCH1_p.N390D
TTTGCTGTACACTCATCACTAGCA	TAGATaCATTTCGAGCCAA	GCGAATAGATACATTTCGAGCCAAAGGAGC	MTRF1_p.T304A
TTTGCTCAGCACATCAGCATACAC	GAGaGTCTGGTGAGCAGGT	GCCTGGAGAGTCTGGTGAGCAGGTGGGGGT	SBNO2_p.S875G
TTTGACATACATCTGCACACGTCT	GAGaGTCTGGTGAGCAGGT	GCCTGGAGAGTCTGGTGAGCAGGTGGGGGT	SBNO2_p.S875G
TTTGTACATGCACACTGCTCGTCT	CAGGaGTTGCTGAGAGAGC	GCCTGCAGGAGTTGCTGAGAGAGCAGGTGG	MYF5_p.E136G
TTTGGTCATCTCTACTCAGATCAG	TGGGGaCATGAGGACCAAT	GCCTCTGGGGACATGAGGACCAATGGGGAC	IGF2R_p.D2163G
TTTGAGTCTGTCTCACACTACTGT	GCCaTCACGGCCGGTATGG	GCCTCGCCATCACGGCCGGTATGGAGGCCA	L3MBTL1_p.H401R
TTTGCACACTACACACTCATCATA	GCCaTCACGGCCGGTATGG	GCCTCGCCATCACGGCCGGTATGGAGGCCA	L3MBTL1_p.H401R
TTTGAGACATCGCTCTACGCTATA	CAAAGaAGGAGACCTGGGT	GCCTCCAAAGAAGGAGACCTGGGTGGGAAA	ADAMTS12_p.E1059G
TTTGGCACAGTCTCATACACTACA	GACaGGGAGTGTCGTCCCC	GCCTAGACAGGGAGTGTCGTCCCCGGGTAC	COPA_p.R583G
TTTGTCACACACTATATCTACGAT	TGAAaCTATACAGAATGAA	GCCGTTGAAACTATACAGAATGAATGGAAG	FAT_p.T2971A
TTTGCGACTCTCATATCACTCATA	TGAAaCTATACAGAATGAA	GCCGTTGAAACTATACAGAATGAATGGAAG	FAT_p.T2971A
TTTGACACTCTATCACACATCATA	GGAGTaCTCGTGTGTGTGC	GCCGGGGAGTACTCGTGTGTGTGCGGGCAG	OBSCN_p.Y3782C
TTTGTGTCACACATCACACTCAGT	CCaCTGTCCCTGGCGCGCA	GCCGCCCACTGTCCCTGGCGCGCACGGCTA	SALL3_p.T533A
TTTGTATCGCGTACTCTACACTAC	CACTaCTGGGAGGTGGACG	GCCGCCACTACTGGGAGGTGGACGTGGGAA	RFPL3_p.Y152C
TTTGTATGCTACGCACACTCGCAT	CCGCTaCCATATGGTGGGC	GCCCTCCGCTACCATATGGTGGGCAGGCGA	TGFBI_p.Y173C
TTTGTACATATATGCACACTCTAG	TGaTCTCCATGCTGGCACA	GCCCGTGATCTCCATGCTGGCACAAGGATC	ITIH2_p.I678V
TTTGTAGCACTACATCATCTCTGC	GTaCCCCCAGTTCATCAGC	GCCCGGTACCCCCAGTTCATCAGCAGGGTG	ABAT_p.Y426C
TTTGCACGCACATCACATCTCTAC	GCGCCaGGGGAGCCGCCAC	GCCCGGCGCCAGGGGAGCCGCCACAGGTCG	CHAF1A_p.R13G
TTTGCACATGCTCACACGCTCACT	CTGCaCCCCTGGATGACGC	GCCCGCTGCACCCCTGGATGACGCTGGCAC	TTC7B_p.H690R
TTTGCTCTCTCTACGTCATCATCA	CAAACCCGAGTGACACGTC	GCCCGCAAACCCGAGTGACACGTCAGGGAT	NT_nontargetX
TTTGCAGATCTACATACACGCGTC	GGACaGCCGTCGCCCCCTC	GCCCCGGACAGCCGTCGCCCCCTCCGGAGG	SOX17_p.Q332R
TTTGGCACATATCTGATACACACA	GGACaGCCGTCGCCCCCTC	GCCCCGGACAGCCGTCGCCCCCTCCGGAGG	SOX17_p.Q332R
TTTGATCGTCTATCTCTATCTCGC	GACGaGTCCGACTCCGGTG	GCCCCGACGAGTCCGACTCCGGTGAGGCCT	LMX1B_p.E160G
TTTGCATACATCACTCTACATGCT	CTGCaTCCCACCATGACCA	GCCCCCTGCATCCCACCATGACCATGGCCT	ONECUT1_p.H84R
TTTGTCATCACTAGCACACTCTGC	TCaGTTCACACAGGTCCAG	GCCCATCAGTTCACACAGGTCCAGCGGGAC	CD38_p.Q134R
TTTGTACACTCGCTACAGTCACAC	GGCGCaGTCGAACCTCCTG	GCCCAGGCGCAGTCGAACCTCCTGGGGAAG	MNX1_p.Q22R
TTTGACAGACACTGCACTCTCTAG	GGAGGaTGGCTGGACCAAG	GCCCAGGAGGATGGCTGGACCAAGGGGCAG	RAPGEF3_p.D551G
TTTGCATCAGCACAGCACTCATGC	GAGaGGCACTACTGGGCTC	GCCCAGAGAGGCACTACTGGGCTCAGGGAA	CD27_p.R30G
TTTGATCGTCACTCTCACACATCT	AGATaGATGTCCTGAAATC	GCCCAAGATAGATGTCCTGAAATCTGGTAT	DENND4C_p.I1123M
TTTGTGCACACACTGCTACACACA	GAACaTCACCTGCACAGGA	GCCATGAACATCACCTGCACAGGACGGGTA	EGFR_p.I569V
TTTGAGATCACATCACTACGTCTG	GAACaTCACCTGCACAGGA	GCCATGAACATCACCTGCACAGGACGGGTA	EGFR_p.I569V
TTTGCTATCACACTGCATCGTCGT	CGCCTaCTCATTGCTGGCC	GCCATCGCCTACTCATTGCTGGCCGGGCTG	SLC26A1_p.Y90C
TTTGTACACTATCTACAGTCTAGT	ATaTTTCTCCCAGGAGGAG	GCCATATATTTCTCCCAGGAGGAGTGGGGG	ZNF547_p.Y19C
TTTGATACATGCTCTCAGTCTCTC	TACCATTGCCGGCTCCCTA	GCCAGTACCATTGCCGGCTCCCTAAGGGAC	NT_nontargetX
TTTGTCTGTCTACTCATACATAGT	ACACCaGAAGGCACACTCG	GCCAGACACCAGAAGGCACACTCGGGGGAG	ZNF133_p.Q260R
TTTGTGACACACAGCATCACGTCG	ACACCaGAAGGCACACTCG	GCCAGACACCAGAAGGCACACTCGGGGGAG	ZNF133_p.Q260R
TTTGAGCATCACAGCACATCACGA	TGCACaTCGCCTCCCGCAG	GCCACTGCACATCGCCTCCCGCAGGGGCAA	ANK1_p.I245V
TTTGCACATATCACAGTACTCACG	GGGaaCTTCTCAGATGCCG	GCCACGGGAACTTCTCAGATGCCGAGGAGG	FBLN2_p.N180D
TTTGCTGCACACTCACTGTCTAGC	CTCCaCAGCCTGCTCCAGC	GCCACCTCCACAGCCTGCTCCAGCTGGATT	COG1_p.H154R
TTTGGTATCGCACTCATCATCGCT	CTCCaCAGCCTGCTCCAGC	GCCACCTCCACAGCCTGCTCCAGCTGGATT	COG1_p.H154R
TTTGGTCTCTGATCACACTCTATG	ACaCCCCAAGCATCAGGAG	GCCACACACCCCAAGCATCAGGAGAGGTGC	CYP4A22_p.H340R
TTTGATATCTCTACAGCTCACACT	ACaCCCCAAGCATCAGGAG	GCCACACACCCCAAGCATCAGGAGAGGTGC	CYP4A22_p.H340R
TTTGCTGCTCTATCACATCACGAT	TCGTTTCCGCTTAACGGCG	GCCAATCGTTTCCGCTTAACGGCGAGGCCA	NT_nontargetX
TTTGACAGTCAGCATCTCTATCAC	GTACaCTCTCAACGACACG	GCCAAGTACACTCTCAACGACACGGGGCTG	PLXNB2_p.T1490A
TTTGACTCACTGCTCTCACTACTC	GTACaCTCTCAACGACACG	GCCAAGTACACTCTCAACGACACGGGGCTG	PLXNB2_p.T1490A
TTTGCTAGTACATCATCATATACT	GAAaCGGATAGAGTGTCTA	GCATTGAAACGGATAGAGTGTCTAAGGAGT	RABGEF1_p.T135A
TTTGGTCTCTCTACTCTGCTACAG	GTGGaGCTGCGGCACCCCG	GCATGGTGGAGCTGCGGCACCCCGCGGTGG	EVPLL_p.E250G
TTTGTGTCTACTGCTCACGTATAT	TACaCTCCCAAAGGATACT	GCATCTACACTCCCAAAGGATACTTGGATC	PAPPA2_p.T1183A
TTTGTACAGCACTATACTCAGTCT	AGTaCCGGCGGACACAGCC	GCATCAGTACCGGCGGACACAGCCAGGTTG	FNDC3B_p.T652A
TTTGTCTATATCACACTCTGTACA	AGTaAGCAGCTGGTGAAGA	GCATCAGTAAGCAGCTGGTGAAGAAGGGAG	DNAH2_p.K293E
TTTGCTCAGTCATCACTCGCACGA	ACCaTTGACCACCTGCGGC	GCATCACCATTGACCACCTGCGGCGGGAAC	CCDC158_p.I414V
TTTGCTCTACACATGCGTATATCA	TTGCaGAAGCTGTTTGCTG	GCAGTTTGCAGAAGCTGTTTGCTGTGGAAG	C17ORF53_p.Q6R
TTTGATACTATATATACTCGTCAT	TTGCaGAAGCTGTTTGCTG	GCAGTTTGCAGAAGCTGTTTGCTGTGGAAG	C17ORF53_p.Q6R
TTTGCGCTATCTACACATCGTCTG	GTGaCGGTAGCTTTTGCAC	GCAGTGTGACGGTAGCTTTTGCACAGGAAA	ZNF79_p.T44A
TTTGACTACTCATCTCACTCATAC	GGGGaGAGGAAAGCGGTCC	GCAGTGGGGAGAGGAAAGCGGTCCAGGCCG	ROBO3_p.E1301G
TTTGACTCACATCACTCTAGCATA	CCAaGGACCAGATTACAGC	GCAGTCCAAGGACCAGATTACAGCAGGAAA	PAICS_p.K62R
TTTGACAGCATCACATATACACAT	CCAaGGACCAGATTACAGC	GCAGTCCAAGGACCAGATTACAGCAGGAAA	PAICS_p.K62R
TTTGCGCACTACATATCATCACAT	ACCaAGAAGCCCTGGGATA	GCAGTACCAAGAAGCCCTGGGATATGGATG	VCAN_p.K431E
TTTGCGACACATACACTCGCTCGA	GGGaGTGGCAAGAGCAACG	GCAGGGGGAGTGGCAAGAGCAACGTGGGCG	LOC728378_p.S75G
TTTGCAGTCTCTATACTCTACTAT	CCAaGCAGGAGGTCGATAA	GCAGGCCAAGCAGGAGGTCGATAATGGAAT	APAF1_p.K585R
TTTGCACTACTCATCGCACACAGT	AAGGaCTTGGAGACCAGCC	GCAGGAAGGACTTGGAGACCAGCCTGGAGA	ADAM12_p.D399G
TTTGTGCATCGACACACACGTCAC	TCGGCaCCAGCCTGCAGCA	GCAGCTCGGCACCAGCCTGCAGCACGGCTT	PRIC285_p.T1889A
TTTGTCACATCTAGTACTACTACG	TAATaGAAAGCTATAAAAA	GCAGCTAATAGAAAGCTATAAAAATGGAGG	DGKI_p.I943M
TTTGATGCTATCACTCTCTCATCG	CTAAaGGTGTGGAGGACGC	GCAGCCTAAAGGTGTGGAGGACGCTGGACT	HIRA_p.K199R
TTTGTGCTATATCATACACATAGA	CGACaTCATCGCTCTGGCC	GCAGCCGACATCATCGCTCTGGCCAGGAAG	CRMP1_p.I377V
TTTGAGACACATCATCAGCTCAGT	AGCaAGCGGACCACGCGAA	GCAGCAGCAAGCGGACCACGCGAACGGTGA	CACNA1D_p.Q17R
TTTGCAGCATCACGTCACATCTAT	AGCaAGCGGACCACGCGAA	GCAGCAGCAAGCGGACCACGCGAACGGTGA	CACNA1D_p.Q17R
TTTGCTACATATACATCACGTCAC	GGCaGCGGCAGCGGGCGGC	GCAGAGGCAGCGGCAGCGGGCGGCGGGCGC	FRMD4A_p.Q785R
TTTGATACATCACACTGTACACTA	CCTGCaGAACTTGGCTCCC	GCAGACCTGCAGAACTTGGCTCCCGGGACC	CLIC4_p.Q67R
TTTGTGTCACACTCTAGACACACA	ATCCTaCTATCCCTCACCT	GCAGAATCCTACTATCCCTCACCTGGGCCC	REL_p.Y387C
TTTGCTCATACTCATACATCTGCA	GGGGaAGGACTGGAAAGGA	GCACTGGGGAAGGACTGGAAAGGAAGGATG	ZNF646_p.E759G
TTTGCACTGACACTACACATCTGC	GGGGaAGGACTGGAAAGGA	GCACTGGGGAAGGACTGGAAAGGAAGGATG	ZNF646_p.E759G
TTTGACTACACTAGCTACTGCTCG	GTGTaTAAGGTAAGGTCCC	GCACGGTGTATAAGGTAAGGTCCCTGGCAC	EGFR_p.Y727C
TTTGCACACTGCACATATATATAG	GTGTaTAAGGTAAGGTCCC	GCACGGTGTATAAGGTAAGGTCCCTGGCAC	EGFR_p.Y727C
TTTGACATCTCGCTACACATATAT	CTCaTCTCCCGGGAAGACG	GCACGCTCATCTCCCGGGAAGACGTGGAAG	C10ORF140_p.I83V
TTTGCATACACTACATACATCATA	ACGGTaCCATGGACCCCGC	GCACGACGGTACCATGGACCCCGCTGGCAC	SARDH_p.T210A
TTTGACTATCTACATACGATACAC	CTGAaTGTCCTCGTGACCC	GCACCCTGAATGTCCTCGTGACCCCGGAGC	MCAM_p.N434S
TTTGATCTGCACATCTATCTATGT	CAGACaCGCTGAGGTACTG	GCACCCAGACACGCTGAGGTACTGAGGGCG	C15ORF43_p.T47A
TTTGCACACTCTCTACACTCTATA	ACAACaAACAGGTGAGCCT	GCACCACAACAAACAGGTGAGCCTTGGAAC	EEF1G_p.K125E
TTTGGCATCACAGCATCTGTCTAT	TTTaTTACAAAAGGCACCT	GCACATTTATTACAAAAGGCACCTGGGAAG	DPP4_p.I397V
TTTGCATCTATCATACACTCTCAT	CTGGaCACCACGGCCGGCG	GCACACTGGACACCACGGCCGGCGAGGTGG	PHLPP1_p.D224G
TTTGTCATATCATAGCTCAGTCTC	CCAGGaCAACCCCCATGAA	GCACACCAGGACAACCCCCATGAAGGGGAG	MLX_p.D224G
TTTGGACTCTAGCACACGTCGTCG	AGGaGGTGTGGCCTGCCCC	GCACAAGGAGGTGTGGCCTGCCCCCGGGGC	YIF1A_p.E81G
TTTGATATATCATCTCAGCACGCG	AGCCaTGGTGGCCAAACAG	GCACAAGCCATGGTGGCCAAACAGCGGATC	SERP2_p.M1V
TTTGACACATGCTCGTCTATACTC	TCTGaCCTGGAGGCCCAGG	GCAAGTCTGACCTGGAGGCCCAGGTGGAGT	KRT35_p.D216G
TTTGGTCTGCTACATCACTACTGA	GTGTaCGCGCTGCAGCCGC	GCAAGGTGTACGCGCTGCAGCCGCTGGACC	PCDHA3_p.Y518C
TTTGCACTATCATCTATCTCACAG	GAGTaCGCCATCGAGCAGG	GCAAGGAGTACGCCATCGAGCAGGTGGGTA	DNAH1_p.Y1156C
TTTGGACACAGCACTCGTATCACG	CTGGaGCACAGCGAGGACG	GCAAGCTGGAGCACAGCGAGGACGAGGGCA	LRRK1_p.E1239G
TTTGTGAGATCATCTACATACTAT	GGTaTGCTCTACCCTGCAC	GCAACGGTATGCTCTACCCTGCACTGGCCA	SHROOM3_p.M490V
TTTGATCACTACACATCAGTACTC	CTGTaTGCAGCCAACCTCC	GCAACCTGTATGCAGCCAACCTCCAGGACA	JMJD7-PLA2G4B_p.Y736C
TTTGGTCACTGCATCATCTGTCGC	CCTaCAAATGTGAAGAATG	GCAACCCTACAAATGTGAAGAATGTGGCAA	ZNF43_p.Y734C
TTTGGTCACATCACTAGCACTCTG	GCCaTGTGGCTCTACCTGG	GCAAAGCCATGTGGCTCTACCTGGCGGTTT	RDH16_p.M1V
TTTGATACACACGTCATCACTCTG	ATaTCGTTATGATAAGGAG	GCAAAATATCGTTATGATAAGGAGTGGTTG	Q86U89_p.Y712C
TTTGTGATCACTCTACACGCACGC	ATaTCGTTATGATAAGGAG	GCAAAATATCGTTATGATAAGGAGTGGTTG	Q86U89_p.Y712C
TTTGCACGTCACTCTCATCACATC	AACaGCAGGAGGGATACGA	GCAAAAACAGCAGGAGGGATACGATGGAGG	LMOD2_p.Q365R
TTTGATCTAGTACTCTCATATACT	CGGTCaCATTCAGCCAGTG	GATTACGGTCACATTCAGCCAGTGTGGCAA	IGSF10_p.H370R
TTTGGCTCGTCTACTCACGCACGC	CAGaTGAAACTGTTAAAGA	GATTACAGATGAAACTGTTAAAGATGGAGT	AP001011.3_p.D88G
TTTGGCACACACACACACTGTCTC	CAGaTGAAACTGTTAAAGA	GATTACAGATGAAACTGTTAAAGATGGAGT	AP001011.3_p.D88G
TTTGGCTACACAGCTATCTCGTAC	CAAGTaCCAGCCGCGGCGG	GATTACAAGTACCAGCCGCGGCGGAGGAAG	SOX9_p.Y174C
TTTGCAGACACTACATCAGCTCTG	CAAGTaCCAGCCGCGGCGG	GATTACAAGTACCAGCCGCGGCGGAGGAAG	SOX9_p.Y174C
TTTGACTCACTACTATCTATCGTC	AGCTaGTGAAAAGCAGCGG	GATGTAGCTAGTGAAAAGCAGCGGCGGCTG	ARFGEF2_p.S848G
TTTGCTCAGTCATCAGTACTACTA	TGCTGaAGCCACCCTAACA	GATGCTGCTGAAGCCACCCTAACATGGTAT	RALGAPB_p.E900G
TTTGATGAGACACACTCACTCAGC	TCaCGGAAGCCTTGGCCCA	GATGATCACGGAAGCCTTGGCCCAAGGTGG	MED15_p.T387A
TTTGAGTCACACACTAGACACGTC	GCAGaCCCTGAAAAAGGCA	GATGAGCAGACCCTGAAAAAGGCAAGGAGA	BMP3_p.T355A
TTTGTGTGCATCTCATCTATCTAC	CAAGGaCACAGTTCGAGGT	GATGACAAGGACACAGTTCGAGGTTGGACC	NT5C_p.D147G
TTTGTGTCACTCTGCTCACTCACG	GTTCTaTTTTGAAGAACTG	GATAAGTTCTATTTTGAAGAACTGGGGAAG	GALNT2_p.Y317C
TTTGAGTATCATCAGCATCTCGCA	GGGGGaCGATCTGAGAATG	GAGTTGGGGGACGATCTGAGAATGGGGGAG	MYO18B_p.D367G
TTTGTCTGCTATCACACTACTGCT	CCGCTaCGACCTGGGCAAG	GAGTTCCGCTACGACCTGGGCAAGGGGGCA	AGRN_p.Y1704C
TTTGGCAGCTACATATATCTCATC	TGGGaAAGCCTTTAGCAAT	GAGTGTGGGAAAGCCTTTAGCAATAGGGCA	ZNF805_p.K462E
TTTGGACATACATATCGACTCTCA	ATaCTGTCCATTCGAGAAC	GAGTGATACTGTCCATTCGAGAACTGGAGC	NELL1_p.I103M
TTTGCGCACTAGCACACTGCTCGA	CTACaCAAGGCCTTTGTGG	GAGTCCTACACAAGGCCTTTGTGGAGGTTA	SERPINB3_p.H330R
TTTGGATCATCTACATCTAGACTC	CTACaCAAGGCCTTTGTGG	GAGTCCTACACAAGGCCTTTGTGGAGGTTA	SERPINB3_p.H330R
TTTGCAGCTCTGCATACTCACTCT	CCaGCCCAGCCTCCCAAGA	GAGTCCCAGCCCAGCCTCCCAAGATGGGGA	LRRC16B_p.S1241G
TTTGATACATCTCATAGTATCATC	TTCTCaTCGCCTGGCTCCC	GAGGTTTCTCATCGCCTGGCTCCCTGGCAG	SLX4_p.H1020R
TTTGCTCTCAGTCATCTACATATC	CTaTCTCCGGTGAGAGGTC	GAGGTCTATCTCCGGTGAGAGGTCTGGGGT	MLL4_p.Y2517C
TTTGGACATACTCTAGTCTCAGCG	CAAATaCCATGAGAAGGTA	GAGGTCAAATACCATGAGAAGGTAAGGCCA	EPHB4_p.Y471C
TTTGACAGTCTCATATCTGCACGT	TCAaGTGACTTAAAATACA	GAGGGTCAAGTGACTTAAAATACAAGGCTA	SMC1B_p.S657G
TTTGCGTACATCATCAGCATCAGC	GGGCaCAGCCTGGCTTGAG	GAGGGGGGCACAGCCTGGCTTGAGTGGAGG	CSPG4_p.T444A
TTTGGCTACTGCATATCGCGTACA	AGGGTaAGGCTGAGGATCG	GAGGGAGGGTAAGGCTGAGGATCGAGGACA	ITGB7_p.K421E
TTTGCGTCATCATCACTCGCTATC	TGGaGGGGAATCCAGGGTG	GAGGCTGGAGGGGAATCCAGGGTGAGGTGC	C19ORF46_p.E340G
TTTGATATGCATCACTCTCACTGT	GGAGGaCGAGCTGAGCGCC	GAGGCGGAGGACGAGCTGAGCGCCAGGCAC	LONP1_p.D248G
TTTGCAGCATCTACACACTGTACA	CTTaTGAGTGTGGAGAATG	GAGGCCTTATGAGTGTGGAGAATGTGGGAA	ZNF814_p.Y604C
TTTGTCTCACTACACTAGCTACTC	CGCaGTCCCAGCATGCACG	GAGGCCGCAGTCCCAGCATGCACGAGGTGA	BAHD1_p.S679G
TTTGTCACACTCACATATCATAGC	CCTTCaAATGCAAAGTGTG	GAGGCCCTTCAAATGCAAAGTGTGTGGCAG	SALL2_p.K660E
TTTGAGCTACTACTACTACACTCA	CACGGaGCCCGACCCGCTC	GAGGCCACGGAGCCCGACCCGCTCCGGGCG	CPZ_p.E615G
TTTGTACAGCATCACTATCACACG	CACGGaGCCCGACCCGCTC	GAGGCCACGGAGCCCGACCCGCTCCGGGCG	CPZ_p.E615G
TTTGTGCACACTAGCACACTATCG	ATCaCCTTAACACACACAC	GAGGAATCACCTTAACACACACACAGGTGC	CTCF_p.H312R
TTTGGCTCTCACTGCGCTACACGC	ATCaCCTTAACACACACAC	GAGGAATCACCTTAACACACACACAGGTGC	CTCF_p.H312R
TTTGATCGCTCTACACATCTCTAC	TTCTaTGAGGCCCTGATTG	GAGCTTTCTATGAGGCCCTGATTGGGGATG	GPANK1_p.Y44C
TTTGATACACACACACGATACATA	GTGCaGGTAAGGAGGGACG	GAGCTGTGCAGGTAAGGAGGGACGCGGCGC	ITPK1_p.R32G
TTTGCAGTCAGCTCAGTACACACT	GGaGCTGGAGAAGAGCCAG	GAGCGGGAGCTGGAGAAGAGCCAGCGGTCC	MPRIP_p.E786G
TTTGCTATGCACACACATCAGTCT	GGACCaCCCTGGGCACAGC	GAGCGGGACCACCCTGGGCACAGCAGGCAT	CCNL2_p.H512R
TTTGTACATATATCTATCAGCACT	AGACTaCGTGTGCGTGGTG	GAGCGAGACTACGTGTGCGTGGTGAGGGCA	BCAM_p.Y123C
TTTGCTACATCATGCACTCGCTAT	AGACTaCGTGTGCGTGGTG	GAGCGAGACTACGTGTGCGTGGTGAGGGCA	BCAM_p.Y123C
TTTGTAGCATCACACACGTCTATA	GTGGaAGCAGTGCGCGCAG	GAGCCGTGGAAGCAGTGCGCGCAGTGGCTC	VAV3_p.K5E
TTTGGTATACTCACTCATAGTATA	CGGaCCTTCCACACCCGGG	GAGCCCGGACCTTCCACACCCGGGCGGCGG	CPEB2_p.D346G
TTTGACGCTCTACTCTACTCATAG	CAGaGGGAGATGGGGCCTG	GAGCCCAGAGGGAGATGGGGCCTGTGGCCT	PTPRT_p.R818G
TTTGTCACAGACTACACTCATCTG	GTCaCTCTCCGCGACACGG	GAGCAGTCACTCTCCGCGACACGGCGGCAG	C7ORF11_p.H65R
TTTGCTACACTATCAGCTCATAGT	TTACAaAGCCAGAGTGGCC	GAGAGTTACAAAGCCAGAGTGGCCAGGAGA	TAAR6_p.K246R
TTTGCTATACAGCACTACATCGAC	TTACAaAGCCAGAGTGGCC	GAGAGTTACAAAGCCAGAGTGGCCAGGAGA	TAAR6_p.K246R
TTTGGACATATATACTCACGCACT	TGCTGaTGTACTGTACCGG	GAGAGTGCTGATGTACTGTACCGGGGGCAT	TSTD2_p.M353V
TTTGTGACATCATATATCATCACT	TGCTGaTGTACTGTACCGG	GAGAGTGCTGATGTACTGTACCGGGGGCAT	TSTD2_p.M353V
TTTGCTAGAGACACTCTCACTCTC	CAGaGAGAAAAGGAAGAAA	GAGAGCAGAGAGAAAAGGAAGAAAGGGAGA	MAP7_p.R494G
TTTGCAGTCTCTATCAGACTCATA	TTCaCGGTGTACGAGTGCC	GAGACTTCACGGTGTACGAGTGCCCGGGCC	NPDC1_p.T286A
TTTGCTCTCTATCTACTCTCAGTA	AGTCaTGGATGTGAGGCGG	GAGACAGTCATGGATGTGAGGCGGGGGCCA	NPHS1_p.M389V
TTTGCGTCACACTACATCTCATCG	TATTaTAGACTGCTGAACG	GAGAATATTATAGACTGCTGAACGTGGAGG	DNAJC28_p.Y53C
TTTGCGACACACACACTAGCATCG	CTTCaGGTGTGGTCAGCTG	GAGAACTTCAGGTGTGGTCAGCTGGGGACT	HOOK2_p.R254G
TTTGTCATACTCACTCTCTACAGT	AAGAaGAATGGGGAAGAGA	GAGAAAAGAAGAATGGGGAAGAGAAGGGCA	PPM1A_p.R25G
TTTGGTATACATCGACTCTCATCT	AAGAaGAATGGGGAAGAGA	GAGAAAAGAAGAATGGGGAAGAGAAGGGCA	PPM1A_p.R25G
TTTGATCTCTATATCATCGACACA	TTGCCaTGGGCTTCATGAC	GACTTTTGCCATGGGCTTCATGACGGGCAC	TMBIM1_p.M175V
TTTGATGTCAGCACACGTCATATC	CCGaTGCACGGGAGCTGAA	GACTGCCGATGCACGGGAGCTGAAAGGGGA	LIMS1_p.D171G
TTTGTCACTATCAGCATATCGTCA	TGCTCaGGGAGATGGCTGC	GACTCTGCTCAGGGAGATGGCTGCTGGGCG	DNAH2_p.R1040G
TTTGGCTCACTGCTCACTCTACGC	GGGaCCGATTCCACCTCCT	GACTCGGGACCGATTCCACCTCCTTGGGGA	SIGLEC12_p.D91G
TTTGGCACACTGTCACATCATCGA	CCaTGGCTGCTGCCCCTGA	GACTCCCATGGCTGCTGCCCCTGAAGGCAA	ITPR1_p.M933V
TTTGTGTCTCATCTCTGCTCTATA	CCAaGGTGGGCCAGTGGGT	GACGCCCAAGGTGGGCCAGTGGGTGGGCAC	OSBPL5_p.K161R
TTTGCTACATACACATACTCTCAT	GTaGGGGCCACCCAGGGCC	GACGAGTAGGGGCCACCCAGGGCCAGGAGA	CDS2_p.*446W
TTTGTATCACTCTACTCTATCTGA	GAACGaCGGTGAGTGCCTG	GACGAGAACGACGGTGAGTGCCTGCGGCCC	NCBP1_p.D11G
TTTGCATACTCAGCTCGCACGCTA	GCTGGaGGAGGTGAGGCAT	GACCTGCTGGAGGAGGTGAGGCATTGGTGG	EGFL7_p.E211G
TTTGGACATACACATCTCTGTATC	CCGGCaGCTCTTTGGGGAC	GACCTCCGGCAGCTCTTTGGGGACAGGAAG	IGF2BP2_p.Q21R
TTTGCGTCGTCTACATCATACATA	AGAGGaGGAAGCCGCGGGC	GACCTAGAGGAGGAAGCCGCGGGCCGGAGC	NKX3-2_p.E140G
TTTGTATACACTCGTCACACGCAC	CGCCaAGAAGAAGTGACGC	GACCGCGCCAAGAAGAAGTGACGCTGGAGC	CDIPT_p.K211E
TTTGCGTCTACTCAGTCATCGCAT	AGGGaCCCCAGCTCCCTGG	GACCGAGGGACCCCAGCTCCCTGGAGGCCC	SEC14L5_p.D199G
TTTGATAGTCTATATCATCTATGC	TCAGGaCGAAGCCTATGAC	GACCCTCAGGACGAAGCCTATGACAGGCGT	MCM4_p.D655G
TTTGCATGTCACTCTACATCTCTG	TCAGGaCGAAGCCTATGAC	GACCCTCAGGACGAAGCCTATGACAGGCGT	MCM4_p.D655G
TTTGTACATCATCTCTACATCACA	CGACaTCTGGGTGCGCAGC	GACCCCGACATCTGGGTGCGCAGCCGGCCC	ARHGEF10L_p.I1219V
TTTGTCATGATCACTCGTCATCTA	CGACaTCTGGGTGCGCAGC	GACCCCGACATCTGGGTGCGCAGCCGGCCC	ARHGEF10L_p.I1219V
TTTGACACACACAGTACATCGTCG	CACAaTGTCGCAGGAGCAA	GACCCCACAATGTCGCAGGAGCAAGGGCCG	C1ORF131_p.M11V
TTTGATCTAGCTCTCTATATCAGT	AAGGTaCCAAGGCAGGGAG	GACCCAAGGTACCAAGGCAGGGAGGGGCCT	CCL21_p.001
TTTGCTCACAGCACTACTGCACAC	GCTaAACAAGAAAAAAATG	GACCAGCTAAACAAGAAAAAAATGAGGTAA	WDR47_p.K414E
TTTGGTCACACATCAGCACATACT	GGCTCaCAGGTGAGGGGGA	GACATGGCTCACAGGTGAGGGGGATGGTCC	ADPRHL2_p.H102R
TTTGTAGCTACAGTACTACATCTC	GGaGGGCAGTGTGGACACC	GACATGGAGGGCAGTGTGGACACCAGGCAG	ABCA7_p.E1055G
TTTGACAGTACATACATATCACTG	CGCTaTTGACAACATCTGC	GACATCGCTATTGACAACATCTGCAGGTGG	PI4KA_p.I512V
TTTGAGCATCTACATCTGTCACTA	TGGaTTCGACCTTTAGTAG	GACAGTGGATTCGACCTTTAGTAGCGGTCA	TMEM184C_p.I14V
TTTGACATCTACATATCGTCACTC	GGTGTaCCGGGAGCGTGGC	GACAGGGTGTACCGGGAGCGTGGCCGGCTC	CRTC1_p.Y105C
TTTGTGTACATCTGCACTACTCGT	CTGaAGCACCCGGAGCAGC	GACAGCTGAAGCACCCGGAGCAGCAGGAGG	IVL_p.K174E
TTTGCAGTCTCATCTGCATACACT	ATGaCGCAGCACCGACGGA	GACAGATGACGCAGCACCGACGGATGGCCA	RBFOX1_p.D114G
TTTGACTATCGATCTACACATCAC	TCTaCCAGAAGGCGGATGA	GACACTCTACCAGAAGGCGGATGATGGGCG	ALDOA_p.Y85C
TTTGCTAGATCATCACACTACTGC	TCTaCCAGAAGGCGGATGA	GACACTCTACCAGAAGGCGGATGATGGGCG	ALDOA_p.Y85C
TTTGACTCTGCTACATCACAGATC	GTCGCCATATGCCGGTGGC	GACACGTCGCCATATGCCGGTGGCAGGGCA	NT_nontargetX
TTTGCACTATCATATATCACAGCT	CAGGaCGCTGTGGCTGCAC	GACACCAGGACGCTGTGGCTGCACTGGATG	RRP9_p.D284G
TTTGCAGTCACTACAGTACACACT	AGCACaGACAGTTGGACGA	GACACAGCACAGACAGTTGGACGAAGGCTC	ULK2_p.Q461R
TTTGCATCTCTATCATATACGTCA	TCAaGTTCATGAAAGTTGA	GACAATCAAGTTCATGAAAGTTGATGGTGC	PREP_p.K154R
TTTGTGACATATCACTACATATCG	CCCTGaCGGACTGGAGGAG	GACAACCCTGACGGACTGGAGGAGGGGGCC	PRR5L_p.D347G
TTTGCATAGCTCATATAGTCTACA	TGTTaCGCAAGTATCGCCA	GAATTTGTTACGCAAGTATCGCCATGGCGA	MTAP_p.Y212C
TTTGTACATGCACTATCAGCTCGC	CAAACaCTTGGTATGTGGG	GAATTCAAACACTTGGTATGTGGGAGGAGC	STAT3_p.H410R
TTTGCTCTATCGTCACTACGTCTA	ACAaGGTGGGTAGAGGACC	GAATGACAAGGTGGGTAGAGGACCAGGGCT	NT5C3L_p.K248R
TTTGTCTACACTCACTCACATGCG	AAGCaAAAGAAACGTGAGA	GAATGAAGCAAAAGAAACGTGAGAAGGAGG	HOXA1_p.Q284R
TTTGCGACACACACAGCACTCGAT	CCaCCTTCTCTGTGATGGC	GAATACCACCTTCTCTGTGATGGCTGGGAG	CRB2_p.T440A
TTTGGTATCATCTATCATCACTCA	ATaCCCATATTTCTCGAGT	GAATAATACCCATATTTCTCGAGTAGGGCA	STT3A_p.T550A
TTTGAGTCACAGCATATCACTGCA	ATaCCCATATTTCTCGAGT	GAATAATACCCATATTTCTCGAGTAGGGCA	STT3A_p.T550A
TTTGCAGCTACGCACTATCATCGT	TCAaTTTAGCACATGATTG	GAAGTTCAATTTAGCACATGATTGTGGATA	ALMS1_p.N2519S
TTTGCACACTCTCAGTACAGCACA	TATaTCATTGCAAACAATG	GAAGTTATATCATTGCAAACAATGTGGGAA	ZNF670_p.Y141C
TTTGATCTATCACACACTGACTCA	TGTTCaAGGAAGCTGTGCA	GAAGGTGTTCAAGGAAGCTGTGCAGGGCAT	CACNA2D2_p.K357E
TTTGATCAGATCACTCTACTCTAG	CCTGaGGGGCATTTACACT	GAAGGCCTGAGGGGCATTTACACTGGGTAT	SLC25A11_p.R78G
TTTGGACATCACATCACTATACAG	CACaGAACACCTGGGGCTG	GAAGGCACAGAACACCTGGGGCTGCGGGAA	LMNA_p.Q436R
TTTGTATGTCACTCATCATCGTCA	AATCGACCGACACTAATGT	GAAGGAATCGACCGACACTAATGTAGGTGT	NT_nontargetX
TTTGTCACATCTCTCACTATCTGT	TGACaGAATGCTTGATATG	GAAGCTGACAGAATGCTTGATATGGGGTTT	DDX17_p.R250G
TTTGTCAGTCATCTACGCACACAT	TCaTCTGAGGAAAGCTGAG	GAAGCTCATCTGAGGAAAGCTGAGAGGGAA	C4ORF26_p.H141R
TTTGGATCTATCTGCTCACATGTA	CTTTCaCCTGCCCCACGTG	GAAGCCTTTCACCTGCCCCACGTGCGGCAA	FEZF1_p.T401A
TTTGTCTCATACTACACTACTAGC	CTTaTGAGTGTAATGATTG	GAAGCCTTATGAGTGTAATGATTGTGGCAA	ZNF16_p.Y405C
TTTGGTCTACTCATCACACACAGT	CGTaTGTCTGCAGGGAGTG	GAAGCCGTATGTCTGCAGGGAGTGTGGGCG	ZNF169_p.Y570C
TTTGATAGCTACACATCAGTCAGA	CGTaTGTATGTAAGCTCCC	GAAGCCGTATGTATGTAAGCTCCCTGGCTG	GLI1_p.Y362C
TTTGAGCGCTACACTCATATATAT	CGTaCGTGTGCCCCGAGTG	GAAGCCGTACGTGTGCCCCGAGTGCGGGCG	ZNF71_p.Y270C
TTTGTCTAGACACTCATACTACGC	CCTaCAAATGTGTACGATG	GAAGCCCTACAAATGTGTACGATGTGGGAA	ZNF540_p.Y495C
TTTGGAGATCATATATCTATCACT	AGTGGaAAATGGATGGGCC	GAAGCAGTGGAAAATGGATGGGCCAGGCTA	DCAF13_p.K289E
TTTGGTACACTCTACTCACTACAG	TGAGGaCGAGGCCGGGACT	GAAGATGAGGACGAGGCCGGGACTAGGGTG	LRRC52_p.D286G
TTTGCTACACTACTCACAGTACGA	TCAaTGCTGTGGTGGAGAC	GAAGATCAATGCTGTGGTGGAGACTGGCCG	SPTBN1_p.N1213S
TTTGGCGACTCACTACTCACTGCG	GTATAaGAAGACATACTCA	GAAGAGTATAAGAAGACATACTCAAGGCGT	SETD2_p.K466R
TTTGCGCACTCACATACATCTATA	GTATAaGAAGACATACTCA	GAAGAGTATAAGAAGACATACTCAAGGCGT	SETD2_p.K466R
TTTGCTCATGCTCAGTCACATCGT	CTTCaGCCTCTGTAGAGAA	GAAGACTTCAGCCTCTGTAGAGAAGGGCAG	IL17RD_p.S254G
TTTGCTCTACTCTCATCGACATCG	AGGaGTGTTCAAAATACGG	GAAGAAGGAGTGTTCAAAATACGGAGGAAA	SLC4A4_p.E629G
TTTGCAGCATCATATCATCATGAC	TTGaCCCTAGGAAGAAAGA	GAACTTTGACCCTAGGAAGAAAGATGGAGC	IPO8_p.D426G
TTTGATCATATCATCAGCATCATC	GTaTCTGTGTGGACTGGAA	GAACTGTATCTGTGTGGACTGGAAAGGTGG	PNLIP_p.I119V
TTTGCTGTCACTCACACTACTGCG	CAGTGaGCAAGTCGCTCAC	GAACTCAGTGAGCAAGTCGCTCACAGGCCT	EMILIN3_p.S595G
TTTGATGTATACACACATACATAG	CACTaTTATGCCGTGGCTG	GAACTCACTATTATGCCGTGGCTGTGGTGA	LTF_p.Y111C
TTTGGCAGCTCTCATCATCATCTA	AGTCCaCCTGTGCGGAGGC	GAACTAGTCCACCTGTGCGGAGGCCGGGTC	MCPH1_p.H780R
TTTGTCACACAGTACACACACTGA	AACGCCGCTCAAGTTGATA	GAACGAACGCCGCTCAAGTTGATAAGGCAA	NT_nontargetX
TTTGGCACACTCACATATATCATG	TTCCaGAAGTGGGCAGCTG	GAACCTTCCAGAAGTGGGCAGCTGTGGTGG	HLA-B_p.Q266R
TTTGACTACTGCTACTCGCTATAG	TTCCaGAAGTGGGCAGCTG	GAACCTTCCAGAAGTGGGCAGCTGTGGTGG	HLA-B_p.Q266R
TTTGTCTCATATCATCATCGCTAT	TCTaCAAGTGTAAAGAATG	GAACCTCTACAAGTGTAAAGAATGTGGAAA	ZNF107_p.Y244C
TTTGGCTCAGCTCTCGCTCTCACT	AGGAAaAGGAGAAGCTTAA	GAACCAGGAAAAGGAGAAGCTTAAGGGTCC	TAF1L_p.K1259E
TTTGGACAGCTATATCTCACTCTC	AGGAAaAGGAGAAGCTTAA	GAACCAGGAAAAGGAGAAGCTTAAGGGTCC	TAF1L_p.K1259E
TTTGGCTCTCAGTCTACATCGACT	AGCTGaCCACACTTCCGGA	GAACCAGCTGACCACACTTCCGGAGGGCAT	CPN2_p.T374A
TTTGGTATCACTATCACTCTACGC	GCCaGGGAACGGCAGCAAC	GAAAGGCCAGGGAACGGCAGCAACAGGTAA	FKBP15_p.Q51R
TTTGCATAGCTCGCTCACATATAC	GATGaTTTAGGAGACAAGA	GAAAGGATGATTTAGGAGACAAGAGGGTCA	EFHB_p.D14G
TTTGACAGCTCACGCACTCTGCTC	CCTaTGAATGTCCTCAGTG	GAAAGCCTATGAATGTCCTCAGTGTGGAAG	ZNF382_p.Y379C
TTTGATGCTCTACATGCTATCGAT	ACTaCGAATGCAAAGACTG	GAAAGACTACGAATGCAAAGACTGTGGGAA	ZNF331_p.Y243C
TTTGTCTATCTATCACTACTATCA	TTTaCAAGTGTAATGAATG	GAAACTTTACAAGTGTAATGAATGTGGCAA	ZNF845_p.Y523C
TTTGTACTCGCTCTATCATACGCT	GCTaTGAGTGTAAGGAATG	GAAACGCTATGAGTGTAAGGAATGTGGAAA	ZNF563_p.Y169C
TTTGTACTATGCACACTACTACTC	CTTaCAAGTGTAATGAGTG	GAAACCTTACAAGTGTAATGAGTGTGGCAA	ZNF28_p.Y638C
TTTGACTACTACACTATCACACAC	CTaGCGACCTGGTGAGGTG	GAAACCTAGCGACCTGGTGAGGTGAGGGCA	ZNF236_p.S1180G
TTTGGTCTCTCATCTACAGTCACG	CGCCAaGTCCTCCCATGTC	GAAACCGCCAAGTCCTCCCATGTCAGGCCG	ABI1_p.S183G
TTTGTGCTCTACTCATCATATAGA	CCTaTGAATGTATTGACTG	GAAACCCTATGAATGTATTGACTGTGGGAA	ZFP90_p.Y553C
TTTGAGCTCACAGTACTCTCACTC	CCTaTGAATGCAAGCAGTG	GAAACCCTATGAATGCAAGCAGTGTGGGAA	ZNF563_p.Y421C
TTTGTACACATCTCTGCTCACGTC	CCTaTGAATGCAAGCAGTG	GAAACCCTATGAATGCAAGCAGTGTGGGAA	ZNF563_p.Y421C
TTTGGACATGCATCTCACACACTC	CCTaTCATTGTAAGGAATG	GAAACCCTATCATTGTAAGGAATGTGGAAA	ZNF850_p.Y359C
TTTGCATACTCACATATACGTCTG	CCTATaAGTGTGGAAAATG	GAAACCCTATAAGTGTGGAAAATGCGGGAA	ZNF556_p.K316E
TTTGACATACATATATCATCTCAT	CCTATaAGTGTGGAAAATG	GAAACCCTATAAGTGTGGAAAATGCGGGAA	ZNF556_p.K316E
TTTGGTCTATCTACTATACTCTGT	CCTaTAAATGTGAAGAATG	GAAACCCTATAAATGTGAAGAATGTGGCAA	ZNF730_p.Y284C
TTTGCTCTCTCGCACATATATACT	CAaGGGAAGATGAAAAAGA	GAAACCAAGGGAAGATGAAAAAGATGGCCA	MPP6_p.R378G
TTTGGCATATGTCACTCTCTACTA	CAaGGGAAGATGAAAAAGA	GAAACCAAGGGAAGATGAAAAAGATGGCCA	MPP6_p.R378G
TTTGACATCACAGTCACTCATATG	ATTaCTGGGAGGTGGACGG	GAAACATTACTGGGAGGTGGACGGAGGACA	BTNL8_p.Y342C
TTTGAGTCACAGTCATATCATATA	ATATaTAGAAAATGTAGTC	GAAACATATATAGAAAATGTAGTCAGGAAT	SAMD9L_p.I901V
TTTGCAGCATCACGTACTACACTA	TGAATaTGAAAGGGCCCGA	GAAAATGAATATGAAAGGGCCCGAAGGGAG	TCHP_p.Y191C
TTTGTCGTCATCTACTCACTCATA	GACaGAAAACAAAATCGTT	GAAAAGACAGAAAACAAAATCGTTTGGTAA	GIN1_p.R57G
TTTGGCTACACATCAGTACAGCAT	ATCAaTGAAAAGAATGCTT	CTTGGATCAATGAAAAGAATGCTTTGGCTG	SPTA1_p.N1836S
TTTGGCTCTCAGATACTCTCTCAT	ATCAaTGAAAAGAATGCTT	CTTGGATCAATGAAAAGAATGCTTTGGCTG	SPTA1_p.N1836S
TTTGTAGACACATATCTACAGCTC	AGTaaCATGGGACAAAAAA	CTTGGAGTAACATGGGACAAAAAAAGGAAT	NHLRC2_p.T481A
TTTGCTAGAGACACTCTACATCGT	AGTaaCATGGGACAAAAAA	CTTGGAGTAACATGGGACAAAAAAAGGAAT	NHLRC2_p.T481A
TTTGCTCGCACTACATACATCTAT	ATCTaGCTGTGGAGCTCCT	CTTGCATCTAGCTGTGGAGCTCCTGGGTGA	UQCRC1_p.001
TTTGACACAGTCTACTACACATCT	CAAaCCTAAAGGAGACATT	CTTGACAAACCTAAAGGAGACATTTGGAGA	MGAT4A_p.N220S
TTTGTGACACTCTCTACTCGATAC	TGGATCGCCCGCAGAAATA	CTTCCTGGATCGCCCGCAGAAATAAGGGAG	NT_nontargetX
TTTGCTGATCATCACATATACATG	TGCaCAGGAAGGACGTCCT	CTTCCTGCACAGGAAGGACGTCCTCGGTGA	ARHGEF10L_p.H273R
TTTGAGACTCTGTATCATCACTAT	CTCaGGAGCAGGTAGGGGC	CTTCACTCAGGAGCAGGTAGGGGCAGGGGG	ARHGAP27_p.Q414R
TTTGTACTCTCACATATCACTATC	GATGaAAAACTGAAGAAGC	CTTAGGATGAAAAACTGAAGAAGCTGGTGG	MYB_p.E49G
TTTGATATGCTCACATCACAGCTC	CCAAaCAAAATGATGAGAC	CTTAGCCAAACAAAATGATGAGACTGGACA	ZFC3H1_p.N941S
TTTGACTAGTCACTATATCACAGT	CAAGAaGGAGGGTATCAAG	CTTAGCAAGAAGGAGGGTATCAAGTGGCAG	KCNIP3_p.K27R
TTTGTCACATCTAGCATCATCTAT	CAAGAaGGAGGGTATCAAG	CTTAGCAAGAAGGAGGGTATCAAGTGGCAG	KCNIP3_p.K27R
TTTGGACACTGCATCTACTCACAT	CAGCaCCGAGGATGGGAAG	CTTACCAGCACCGAGGATGGGAAGAGGCCA	HIVEP3_p.T1475A
TTTGATATACACACACTATACTAG	AGGAGTCGCCGATACGCGT	CTTACAGGAGTCGCCGATACGCGTAGGTCA	NT_nontargetX
TTTGGCTGCATCACACGCTATCGT	AGGaGGTAAAGAAGGAGCC	CTTAAAGGAGGTAAAGAAGGAGCCAGGAGA	MAML2_p.E264G
TTTGCTCAGTCTACATACTCTACT	TGAATaCTACCATCGCCTG	CTGTTTGAATACTACCATCGCCTGAGGAAC	LGALS9_p.Y329C
TTTGAGCTCACATGCATCGCACTA	GTGGGaCAGGGCCAGCCAC	CTGTGGTGGGACAGGGCCAGCCACCGGGGG	C2ORF85_p.D77G
TTTGGACATACTCTACTCTCACAG	GTGGGaCAGGGCCAGCCAC	CTGTGGTGGGACAGGGCCAGCCACCGGGGG	C2ORF85_p.D77G
TTTGTCTCAGTCTATCGTCAGTCT	GGCaTCCTCCCCTGCGGCT	CTGTGGGCATCCTCCCCTGCGGCTCGGGCA	SPHK2_p.I237V
TTTGTACTACATCATCGCTGCTCT	GGCaTCCTCCCCTGCGGCT	CTGTGGGCATCCTCCCCTGCGGCTCGGGCA	SPHK2_p.I237V
TTTGGACACTGTCTACATATACTC	GCTCCaGCTGTGGGGGCTG	CTGTGGCTCCAGCTGTGGGGGCTGTGGCTC	KRTAP5-1_p.S13G
TTTGTGCATCATCTCTCTCATCAT	GCTCCaGCTGTGGGGGCTG	CTGTGGCTCCAGCTGTGGGGGCTGTGGCTC	KRTAP5-1_p.S13G
TTTGGATCTACATCATGCACACTG	GACaTTGCAAGTGCAGCCA	CTGTGGACATTGCAAGTGCAGCCAAGGTGA	WDR46_p.I182V
TTTGCGTCACACATCTCTCGCTAC	ACTCCaGCTGTGGGAGCTG	CTGTGACTCCAGCTGTGGGAGCTGTGGCTC	KRTAP5-9_p.S20G
TTTGACTCACATCATACTATACAG	CAGCaTGGTCCTGGAACTC	CTGTCCAGCATGGTCCTGGAACTCAGGGGC	THBS1_p.M280V
TTTGCTGCTATCGTCTACACACAG	AGCCaGCACTGGGCAACCT	CTGTCAGCCAGCACTGGGCAACCTGGGCCC	ZER1_p.Q699R
TTTGCTATCACATGTCACTATCAT	GCCCaGTGCCAGACCCTCT	CTGTAGCCCAGTGCCAGACCCTCTTGGGCC	GBF1_p.Q445R
TTTGATAGTCTACAGTCACTATAT	TCCaGCTCTACAGCCCCGG	CTGGTTCCAGCTCTACAGCCCCGGAGGGGT	CMIP_p.Q433R
TTTGCACTATCACACACTGCGATA	GTaTGACCGAGAGGTTCAG	CTGGTGTATGACCGAGAGGTTCAGTGGACG	ENTPD7_p.Y507C
TTTGCTGTCTGTCTACATCTATCA	CAGTGaTGGAACGTCCCCT	CTGGTCAGTGATGGAACGTCCCCTGGGGAA	SH2B1_p.D216G
TTTGAGTCTCTATCATACATCGTC	GAGGaCAGATTCAAACCTG	CTGGGGAGGACAGATTCAAACCTGTGGTAC	GALNT7_p.D64G
TTTGAGTCACAGCTCTCGCTCTAG	AGTTGaCTACATGCATGAG	CTGGGAGTTGACTACATGCATGAGAGGTAT	NEK11_p.D147G
TTTGACACTACTCTCTAGATCATA	AGAACaGGGTACGATAACC	CTGGGAGAACAGGGTACGATAACCGGGAGA	BCL2_p.T7T
TTTGATACACACTACATACTACTA	AGAACaGGGTACGATAACC	CTGGGAGAACAGGGTACGATAACCGGGAGA	BCL2_p.T7T
TTTGTCTCTCATCACACACACATA	ACGaGCCCCCGCCACGTGG	CTGGGACGAGCCCCCGCCACGTGGAGGCAG	SYDE2_p.E118G
TTTGATGACACACATCAGCACGTC	TACAaGGGCGAGAGCTGTG	CTGGCTACAAGGGCGAGAGCTGTGAGGAAG	ODZ4_p.K653R
TTTGTGTCAGTCATCTCACGAGTA	TACAaGGGCGAGAGCTGTG	CTGGCTACAAGGGCGAGAGCTGTGAGGAAG	ODZ4_p.K653R
TTTGCAGTCACTATCACATCGTCA	GTaTAAGCCACTCTACAGC	CTGGCGTATAAGCCACTCTACAGCTGGGAG	HSD3B2_p.Y339C
TTTGATACTCACTACACTCTCTCT	GGaGCTGGACCAGCTGCTG	CTGGCGGAGCTGGACCAGCTGCTGCGGCAG	NOG_p.E103G
TTTGACATACACATCTATCAGTAC	GGaGCTGGACCAGCTGCTG	CTGGCGGAGCTGGACCAGCTGCTGCGGCAG	NOG_p.E103G
TTTGATGTACATACACTCACGCTC	GCTaTGTGGGAGCCGTCGG	CTGGCGCTATGTGGGAGCCGTCGGAGGCTT	SERINC5_p.Y156C
TTTGTACACATGTCTCTATATCAC	CTGaCGCACGCACTGGCCA	CTGGCCTGACGCACGCACTGGCCAAGGCGT	WNT9A_p.T134A
TTTGAGCTCACTCACACACTCAGA	ACCTCaCCTGCTCTGCTGC	CTGGCACCTCACCTGCTCTGCTGCAGGGGA	CDKN1A_p.S132S
TTTGGCTCTCTCACTGTCACAGCG	ACCTCaCCTGCTCTGCTGC	CTGGCACCTCACCTGCTCTGCTGCAGGGGA	CDKN1A_p.S132S
TTTGGATACTCATCTCATCTCGCT	TCCaAAAACTTAATAGCTT	CTGGATCCAAAAACTTAATAGCTTTGGTAT	TTC3_p.Q598R
TTTGCAGCTATCATACACACGATA	TAATaTAAAGAATTGCTCC	CTGGATAATATAAAGAATTGCTCCTGGTAA	CAPZA3_p.I299M
TTTGATCACTACTCAGCATCACTG	GGCTGaGTGTGCGCTGTGG	CTGGAGGCTGAGTGTGCGCTGTGGCGGGTG	SP140L_p.S356G
TTTGGTACTATATCATCACACGAC	GCTGaGTGAGCCCCAGTTC	CTGGAGCTGAGTGAGCCCCAGTTCCGGTCA	ATG2A_p.S674G
TTTGGACATACTACACTACATCTG	GCaGCAGCGGCAGCGGCAG	CTGGAGCAGCAGCGGCAGCGGCAGCGGCAG	ZDHHC18_p.S50G
TTTGATCACAGTACATCACGTCTA	GCaGCAGCGGCAGCGGCAG	CTGGAGCAGCAGCGGCAGCGGCAGCGGCAG	ZDHHC18_p.S50G
TTTGGTCATGCGCTACACGCTCGT	GAGaAACCCTTTGAATGTA	CTGGAGAGAAACCCTTTGAATGTAAGGAAT	ZNF662_p.K274E
TTTGAGTATACTCGTATCACTACA	GAGaAACCCTTTGAATGTA	CTGGAGAGAAACCCTTTGAATGTAAGGAAT	ZNF662_p.K274E
TTTGCGCTACATACTACTCTACAG	CTACAaTAAGTACTACGAA	CTGGACTACAATAAGTACTACGAATGGGGA	FPR3_p.I167V
TTTGACATCTAGCACTCTCATCTA	CTACAaTAAGTACTACGAA	CTGGACTACAATAAGTACTACGAATGGGGA	FPR3_p.I167V
TTTGCAGACACACATGCACTCTGT	CCTGaCTTGCTAAGGAAGC	CTGGACCTGACTTGCTAAGGAAGCAGGGTC	MBD5_p.D686G
TTTGCTATATCTCATATCTGCACG	ACTaTaTTAAAGGCCTTGA	CTGGAACTATATTAAAGGCCTTGATGGAAG	ACAD10_p.I75M
TTTGACTGCTCAGTCTCATCAGAT	GTGCaCAACAGTGAAATCC	CTGCTGTGCACAACAGTGAAATCCAGGAGA	FRG2C_p.H134R
TTTGTATCAGTATCTACATCATAG	CTACaGCAGGCGAGGAGTC	CTGCTCTACAGCAGGCGAGGAGTCAGGCTT	MYO7A_p.001
TTTGGCTCACTCTACTCTGTATAT	CAGAaGACTCCAGCCAAAG	CTGCTCAGAAGACTCCAGCCAAAGTGGTGT	BCL9_p.K171R
TTTGTCACACTCACATCACGTATA	CAGAaGACTCCAGCCAAAG	CTGCTCAGAAGACTCCAGCCAAAGTGGTGT	BCL9_p.K171R
TTTGCTGCTCTATCATACATCGAC	GGAaGGTCACCAGGGAGGT	CTGCGGGAAGGTCACCAGGGAGGTAGGTGA	NKD2_p.K138R
TTTGTCAGTACTCACACTCTCTCG	GCTGCaCACGGTCAACTCC	CTGCGGCTGCACACGGTCAACTCCAGGCAC	ZFHX3_p.H1058R
TTTGACATCATCTACACTCGATAT	GCTGCaCACGGTCAACTCC	CTGCGGCTGCACACGGTCAACTCCAGGCAC	ZFHX3_p.H1058R
TTTGAGCACACACTCTACAGTCAG	GCTaCTCTGGCGGCGGCTC	CTGCGGCTACTCTGGCGGCGGCTCTGGCTG	LOR_p.Y189C
TTTGTACACATATACTACTCGTCT	GATCCaCACCTCAGAGGGG	CTGCGGATCCACACCTCAGAGGGGAGGCAC	OR10G9_p.H228R
TTTGTATACATACACACATGCGCT	CGCaTGCGGCACATCCCCT	CTGCCCGCATGCGGCACATCCCCTTGGCCC	DNMT1_p.M1425V
TTTGCTGCTCATATATCTACATAC	CGCaTGCGGCACATCCCCT	CTGCCCGCATGCGGCACATCCCCTTGGCCC	DNMT1_p.M1425V
TTTGTCTCTCATCAGCATCATCGT	CAAGaCATTAGGTACCCTG	CTGCCCAAGACATTAGGTACCCTGTGGATG	NHLRC1_p.D173G
TTTGTGCTATCACTATATCTAGTA	CAAGaCATTAGGTACCCTG	CTGCCCAAGACATTAGGTACCCTGTGGATG	NHLRC1_p.D173G
TTTGCTACACATATCTATCAGACT	ATGAaACTACTTCGTGTCC	CTGCCATGAAACTACTTCGTGTCCTGGCCT	RPAP1_p.K623R
TTTGATCACATCTATATCATCGAG	GCAGCaGGGCGGTGCCCCA	CTGCAGCAGCAGGGCGGTGCCCCAGGGACA	PKNOX2_p.Q388R
TTTGAGTCACGCTACACTCATCGT	GACCaCATGCTGGCCTAGG	CTGCAGACCACATGCTGGCCTAGGCGGCCT	JUP_p.H742R
TTTGATATCTATCTCTATCATCAG	TTAAaCACGCTGCTCTGGG	CTGATTTAAACACGCTGCTCTGGGAGGCAG	CPXM2_p.N460S
TTTGCGACACACACTCTATCGTCA	GCAAGaTGGGCATCGGCAG	CTGATGCAAGATGGGCATCGGCAGCGGGGC	CCDC88B_p.D1147G
TTTGATACGTCACATCTCTGCTCT	AAAGaGCTTGGGGAAGCAA	CTGATAAAGAGCTTGGGGAAGCAAAGGTAA	CEP135_p.E343G
TTTGTCATCTCGATCACACTCTCA	AAAGaGCTTGGGGAAGCAA	CTGATAAAGAGCTTGGGGAAGCAAAGGTAA	CEP135_p.E343G
TTTGATCATGCTCTACATATCAGT	TGCGaCCCCCACCCCCCTG	CTGAGTGCGACCCCCACCCCCCTGGGGCTG	PEX16_p.T209A
TTTGCTATATCATCAGCGTATACT	TCAGaCCAGTAGGTCATCC	CTGAGTCAGACCAGTAGGTCATCCCGGATG	SCN1A_p.T625A
TTTGCACTACAGCTATCACTCTGA	TAAGCaAAGTGGCAGCTTG	CTGAGTAAGCAAAGTGGCAGCTTGGGGCTT	PKHD1_p.Q4040R
TTTGTACACATATACTCACTATAG	GGCTaCGTCCCCTGTTGGC	CTGAGGGCTACGTCCCCTGTTGGCCGGAGC	ERICH1_p.Y78C
TTTGCTCTCATATCTCATCACGAT	GGCTaCGTCCCCTGTTGGC	CTGAGGGCTACGTCCCCTGTTGGCCGGAGC	ERICH1_p.Y78C
TTTGGCACTCTAGTATCACATCGC	GCTGTaCGCCCGGCGCCGG	CTGAGGCTGTACGCCCGGCGCCGGCGGCCC	RARG_p.Y353C
TTTGGATCAGTCTCACTATCGATA	GCTGTaCGCCCGGCGCCGG	CTGAGGCTGTACGCCCGGCGCCGGCGGCCC	RARG_p.Y353C
TTTGTGTATCACATACTACTACAC	GCAGaaCAGCAAATAACTG	CTGAGGCAGAACAGCAAATAACTGAGGTCT	MKI67_p.E3102E
TTTGCACACACATATCACGATCAC	CTCaGTGACCCCCTGGTGC	CTGAGCTCAGTGACCCCCTGGTGCTGGTGA	LILRB2_p.S110G
TTTGACATCTCATCTCTGCTCACA	AAGaTCCGCAAAATCGGGG	CTGAGAAGATCCGCAAAATCGGGGAGGCGG	FLOT2_p.I319V
TTTGACACTCTATCAGTCTATCGA	TTCaCTCTGAAGGTGGAAG	CTGACTTCACTCTGAAGGTGGAAGTGGAAT	QPRT_p.T195A
TTTGAGCACTATCACACTCATGCT	TCCaGCAGCAGCCGGCTGT	CTGACTCCAGCAGCAGCCGGCTGTGGGACC	MAMSTR_p.S300G
TTTGTCTCTACATATCACGCACAT	ACTGaGCCTGAGGACGAGA	CTGACACTGAGCCTGAGGACGAGAAGGTTG	PIK3AP1_p.E154G
TTTGTCATCACATATATCTATATA	GTCTTaCAGCTCTAAAGGG	CTGAAGTCTTACAGCTCTAAAGGGCGGCAC	OR4C6_p.Y226C
TTTGTACGTCTATCTATATCACGT	GATCaGGGGATGCTTGAGC	CTGAAGATCAGGGGATGCTTGAGCCGGCAG	SLC27A5_p.R105G
TTTGTCTCACAGCTACTACGTCTG	CCTCCaTGACTGAAGGCAG	CTCTTCCTCCATGACTGAAGGCAGTGGGAC	LIMCH1_p.M1232V
TTTGGATCTCACACTATACTCGCA	CAAGGaTGGCTATGGAGGA	CTCTCCAAGGATGGCTATGGAGGATGGCAG	RNF215_p.D229G
TTTGCACTCTCACATGTCATATAG	AAGaGGGCAGCAGCTGAGC	CTCGCAAGAGGGCAGCAGCTGAGCAGGACG	SIGLEC11_p.R594G
TTTGTCTATCACTATATCATCTGA	TGTCCaGCTGGCCACTGCC	CTCCTTGTCCAGCTGGCCACTGCCAGGCCT	TSEN34_p.Q186R
TTTGGACTATCGCTATCACTCACT	GTAaCCTTACACAACAGTG	CTCCTGTAACCTTACACAACAGTGAGGGGG	PDGFRA_p.T160A
TTTGCGCTCACATCTCAGCTCACT	GTAaCCTTACACAACAGTG	CTCCTGTAACCTTACACAACAGTGAGGGGG	PDGFRA_p.T160A
TTTGGAGATCATCACACATAGTCA	CCTaCAGCACGCAGTGCAG	CTCCTCCTACAGCACGCAGTGCAGCGGACC	BAI1_p.Y386C
TTTGAGCACTCACATCTCTATGTA	ACTaCGCTTGGTCGCCGCC	CTCCTACTACGCTTGGTCGCCGCCCGGCAC	ILDR2_p.Y566C
TTTGCTCACTAGCACTCACTACGT	TGGGTaAGGCCACGGAGGG	CTCCCTGGGTAAGGCCACGGAGGGAGGATC	ZNF783_p.001
TTTGCAGTCATCTGTACTACGTCA	GGGaGGGTGGAGGTGAGGG	CTCCAGGGAGGGTGGAGGTGAGGGTGGACC	INTS5_p.E976G
TTTGCAGTCTGCATCACACATATA	GGGaGGGTGGAGGTGAGGG	CTCCAGGGAGGGTGGAGGTGAGGGTGGACC	INTS5_p.E976G
TTTGATAGACATCATATCACTCAG	CGCTaCTGGCTCAAAGAGA	CTCCACGCTACTGGCTCAAAGAGAGGGAAA	GON4L_p.T126A
TTTGAGACACTACTACATCAGATC	CCCaCCTGGTGGACATGGC	CTCCACCCACCTGGTGGACATGGCTGGCTC	ZSWIM3_p.H522R
TTTGCATATATACATACTCTCAGA	CCAGGaGCAGCTCCGGCAG	CTCAGCCAGGAGCAGCTCCGGCAGTGGTCT	CCR7_p.E350G
TTTGTCACTAGCTACTCGTCACGC	CCAGGaGCAGCTCCGGCAG	CTCAGCCAGGAGCAGCTCCGGCAGTGGTCT	CCR7_p.E350G
TTTGGTACTCTCTACTCACTCTCT	ATGTaCCTCTCCCTTGCCA	CTCAGATGTACCTCTCCCTTGCCATGGGCT	OR13F1_p.Y102C
TTTGGCACATCATCTACATATAGA	ATGTaCCTCTCCCTTGCCA	CTCAGATGTACCTCTCCCTTGCCATGGGCT	OR13F1_p.Y102C
TTTGCAGCTGCTCTACTCTCATAT	CATATCGGGGCGAGACATG	CTCACCATATCGGGGCGAGACATGAGGTTT	NT_nontargetX
TTTGCTGCGCACTACACATAGTAC	AATATCGGGTGCTACAGGA	CTCACAATATCGGGTGCTACAGGAAGGCAA	NT_nontargetX
TTTGCTGCACACATCACTCACGCG	CGTGaCGGGGTATGTCCAA	CTATCCGTGACGGGGTATGTCCAAGGGCCT	SPTA1_p.D558G
TTTGTCTACAGCTCATATACACAC	CGTGaCGGGGTATGTCCAA	CTATCCGTGACGGGGTATGTCCAAGGGCCT	SPTA1_p.D558G
TTTGAGCGTCACATCTACTACAGT	GCGaTGAATCACCTGAAGC	CTATAGCGATGAATCACCTGAAGCTGGTAA	SENP6_p.D917G
TTTGTAGTCTCATACATCACATGC	GCTCGaCCCCAAGTGCAGG	CTAGAGCTCGACCCCAAGTGCAGGGGGCTG	NGEF_p.D305G
TTTGACACAGCACTACGTACTACA	GCTCGaCCCCAAGTGCAGG	CTAGAGCTCGACCCCAAGTGCAGGGGGCTG	NGEF_p.D305G
TTTGTACGTCTACTCTCTATCATG	ACCACaTGGACTTGGCCAA	CTAGAACCACATGGACTTGGCCAAAGGTCA	EXOC1_p.M280V
TTTGACAGTCTACACACACTAGTA	TGTGTaACAGTTCCTGCAT	CTACATGTGTAACAGTTCCTGCATGGGCGG	TP53_p.N146D
TTTGCATCACAGATCACACACGAC	TGTGTaACAGTTCCTGCAT	CTACATGTGTAACAGTTCCTGCATGGGCGG	TP53_p.N146D
TTTGTCTCATCTCATCACTCACAT	TCGaCCTCGGCGCTCTGGC	CTACATCGACCTCGGCGCTCTGGCTGGCTA	MAP3K8_p.D447G
TTTGTGACTCACGTCTATCACATG	ATCCaCAAAGTAAATAGCA	CTACAATCCACAAAGTAAATAGCATGGTGG	MAD2L1_p.H191R
TTTGATGTACTACATCATCTATGT	ATCCaCAAAGTAAATAGCA	CTACAATCCACAAAGTAAATAGCATGGTGG	MAD2L1_p.H191R
TTTGATCAGATCTCACGTCATATC	AGGaCGAGTTCTCGGGCAG	CTACAAGGACGAGTTCTCGGGCAGAGGCGA	CYP2E1_p.D95G
TTTGGACTACACGTCTATCATACA	AACCaTCACAGTGAGGGGG	CTAATAACCATCACAGTGAGGGGGAGGAAT	ERAP1_p.I535V
TTTGATCATACAGCTCATATACAG	TGGaGGCATCACCCAGCAG	CTAACTGGAGGCATCACCCAGCAGTGGTGG	RALGAPB_p.R228G
TTTGATGCATCATCGATCACTAGC	TGCGaCTTCGCGGCTTCGC	CGTTGTGCGACTTCGCGGCTTCGCAGGAGG	ZNF536_p.D306G
TTTGTAGCACACAGTCACACTGTC	GTCaGAGGAGTCTTCATGA	CGTTGGTCAGAGGAGTCTTCATGAAGGTGG	C10ORF11_p.R134G
TTTGGTACACATATCACTACTACA	GTCaGAGGAGTCTTCATGA	CGTTGGTCAGAGGAGTCTTCATGAAGGTGG	C10ORF11_p.R134G
TTTGACTCATACTCATCGCTCTCT	TAGCCCTCGATTGGTTGCG	CGTGTTAGCCCTCGATTGGTTGCGAGGGTG	NT_nontargetX
TTTGCATCTCTAGCACATACATCG	GCCaCGCCCGCAACGCGCA	CGTGTGCCACGCCCGCAACGCGCACGGCCA	OBSL1_p.H210R
TTTGCATGACATCTCTATCACGTC	GCCGCaTCGCGCAGGACCT	CGTGGGCCGCATCGCGCAGGACCTGGGGCT	PCDHA9_p.I48V
TTTGCACACTCTACATCTATATCT	AGTaCATCACCAGCAGGTG	CGTGGAGTACATCACCAGCAGGTGCGGCTG	POLE_p.Y1889C
TTTGGCTCATACTACTGCATCGCG	AGTaCATCACCAGCAGGTG	CGTGGAGTACATCACCAGCAGGTGCGGCTG	POLE_p.Y1889C
TTTGACGACACATCTCACATCAGA	AGAaGTACATGGACGTGTC	CGTGGAGAAGTACATGGACGTGTCAGGCCT	HOXD13_p.K158E
TTTGCACACTACTGTACATCACGC	ACCTCaCCATTCAGGAGGA	CGTGCACCTCACCATTCAGGAGGAGGGGGC	KCNE4_p.T137A
TTTGGACATCGCTATATCACATCA	GAGGATCATGTCGAGCGCC	CGTCTGAGGATCATGTCGAGCGCCAGGATC	NT_nontargetX
TTTGAGTCTACACATCACAGCATC	CCGaCAGCTGCGTGGCCAG	CGTCCCCGACAGCTGCGTGGCCAGCGGGCT	SLC18A3_p.T102A
TTTGCGCACTCAGCACGCACACAC	AGGCaGCCCTGGCCGCGCC	CGTCCAGGCAGCCCTGGCCGCGCCGGGAAT	COL7A1_p.S1309G
TTTGTGTCATGCTCACATCACATG	TCGaGTGTGACGTGGTGAA	CGTCATCGAGTGTGACGTGGTGAAAGGTAA	RBM14_p.E107G
TTTGGCATCGTCACATACATCATA	GTaTGACCACAGTGGGGTA	CGTCAGTATGACCACAGTGGGGTACGGGGA	KCNS2_p.M372V
TTTGGCACAGCATCTCACTATCGA	GGCCTaTGCAGGAGGTGAT	CGTCAGGCCTATGCAGGAGGTGATGGGCCT	ZBTB5_p.M482V
TTTGGCTCTCATAGTCTCTATCAT	GCTaCGGAGGCTACGGATA	CGGTGGCTACGGAGGCTACGGATACGGCTC	KRTAP19-5_p.Y41C
TTTGACACTGCATATATATCACTC	GCCTaCAGCGGGGGCCCTG	CGGTGGCCTACAGCGGGGGCCCTGCGGAGC	LDB3_p.Y367C
TTTGAGCTCTCATCATCGAGTACT	CATGaGGGCGCATGCGCAG	CGGTGCATGAGGGCGCATGCGCAGCGGGGC	SUMF2_p.R2G
TTTGCATACTCATCATACTATCTG	CACCaTGGAACTTAAAGTA	CGGTGCACCATGGAACTTAAAGTATGGGTG	RASSF8_p.M1V
TTTGAGCATCTCACTCTCAGTAGT	ATaACAACTTGGAAAGGAG	CGGTGATAACAACTTGGAAAGGAGAGGGAA	DAZAP2_p.N145D
TTTGTCTGCATCATCACACTATGA	AACaCCTCCAAGCTGCTCA	CGGTCAACACCTCCAAGCTGCTCAGGGACG	POLRMT_p.T370A
TTTGTCTACATACACTCTATGCGA	AACaCCTCCAAGCTGCTCA	CGGTCAACACCTCCAAGCTGCTCAGGGACG	POLRMT_p.T370A
TTTGACGCTATATCACACTACACT	CTTCCaCAGTGCCCCTGGC	CGGGCCTTCCACAGTGCCCCTGGCCGGCCG	OSBP2_p.H160R
TTTGGCATCTCTCTCTCTATCTCA	CGACaTGGGCGCCGCCGCG	CGGGCCGACATGGGCGCCGCCGCGTGGGCA	POFUT1_p.M1V
TTTGTAGCTACACGTCACACATCG	CAGGaCCTCGGCCACCAAC	CGGGCCAGGACCTCGGCCACCAACGGGACG	LPAR5_p.T319A
TTTGGACTCACATCGATCATCTAT	CAGGaCCTCGGCCACCAAC	CGGGCCAGGACCTCGGCCACCAACGGGACG	LPAR5_p.T319A
TTTGCATGTATACACTCGTCTATA	GGGGGaCCCAGCTCAGGAC	CGGGAGGGGGACCCAGCTCAGGACTGGGAG	C17ORF39_p.T11A
TTTGTACATCTCTCTATATCATGA	GGCAGaGCGGCTCAGCCAG	CGGGAGGCAGAGCGGCTCAGCCAGCGGCAG	AKAP13_p.E2673G
TTTGGCTCTACAGCATCATATATC	GGCAGaGCGGCTCAGCCAG	CGGGAGGCAGAGCGGCTCAGCCAGCGGCAG	AKAP13_p.E2673G
TTTGACTATCATCGTATATCTCAC	GCaTCCTGATCTGCCGCTG	CGGGAGCATCCTGATCTGCCGCTGTGGTGC	PHF20_p.H771R
TTTGACTGCACATACACTCGATAT	TCCaGGCCTACAGCAACAA	CGGCTTCCAGGCCTACAGCAACAATGGTAA	CDHR2_p.Q906R
TTTGTCATACATCATGCTCGCACT	ACCTGaTCGTGTATGTCAC	CGGCTACCTGATCGTGTATGTCACAGGCCG	PITPNM1_p.I1062V
TTTGTCAGCTACTGTCACTATCTG	ACCTGaTCGTGTATGTCAC	CGGCTACCTGATCGTGTATGTCACAGGCCG	PITPNM1_p.I1062V
TTTGTATACTACTACATCTACATG	GCGGCaGCAGCTCCGGCGG	CGGCGGCGGCAGCAGCTCCGGCGGCGGATA	KRT10_p.S551G
TTTGATCTCACTGCACTACTCGTA	GCGGCaGCAGCTCCGGCGG	CGGCGGCGGCAGCAGCTCCGGCGGCGGATA	KRT10_p.S551G
TTTGGTACAGCATCGTCTATAGTA	GCGaCGGCCGCGGCAGCCC	CGGCGGCGACGGCCGCGGCAGCCCTGGCGG	SLC25A16_p.T5A
TTTGACACAGCATCACTATATCGT	CGCaAGGCCGCCGTCGCGC	CGGCGCGCAAGGCCGCCGTCGCGCCGGGGC	MAGI2_p.K1426E
TTTGACTATCACATGCTCTACAGA	TGTGCaGCCTGGGGGCGGT	CGGCCTGTGCAGCCTGGGGGCGGTGGGAGC	EPDR1_p.S152G
TTTGGCATACACACATATCACGTC	GTGGaCCCCGTGGCGGTTC	CGGCCGTGGACCCCGTGGCGGTTCTGGCTG	SLC9A1_p.D238G
TTTGCACTCATCATATCATCTACA	GTGGaCCCCGTGGCGGTTC	CGGCCGTGGACCCCGTGGCGGTTCTGGCTG	SLC9A1_p.D238G
TTTGCGCACACATCTGCATATCTA	GCCaTGCGCACCCTGGTGA	CGGCCGCCATGCGCACCCTGGTGAAGGAGC	TUBGCP2_p.M296V
TTTGTCTACTAGCACTCAGCACGT	GCCAGaGCCAGGAGGGAGC	CGGCCGCCAGAGCCAGGAGGGAGCGGGGCT	TFAP2C_p.S108G
TTTGTCACTCTCTCATCATAGCGA	GACCaGCAAGAGCGAGAGG	CGGCCGACCAGCAAGAGCGAGAGGGGGCCC	HSPBP1_p.Q117R
TTTGACTAGCACAGTCTACATCGT	CATGaGGGCCTGGTGGCCA	CGGCCCATGAGGGCCTGGTGGCCACGGTGA	NCOR2_p.E1412G
TTTGCATCTCTGTCTACTCTCATA	CATGaGGGCCTGGTGGCCA	CGGCCCATGAGGGCCTGGTGGCCACGGTGA	NCOR2_p.E1412G
TTTGAGACACACTACACTCTCGTA	AGGCTaTGAGTATGGCCCC	CGGCCAGGCTATGAGTATGGCCCCGGGCCC	LTBP2_p.Y1655C
TTTGTCTCAGTATCATCTCACACA	ACCCaCTTGTCACCGGCCC	CGGCCACCCACTTGTCACCGGCCCTGGCCC	TRIM9_p.H112R
TTTGCATCTCATCTATGTCATCAC	ACCaTGGTGGAGCTGGGAA	CGGCCACCATGGTGGAGCTGGGAAAGGACA	GIPC1_p.M287V
TTTGCTGTCTGTCACACATCGTCA	TACaTGGCCCCGGAGGTAG	CGGAGTACATGGCCCCGGAGGTAGTGGAGG	MKNK2_p.M257V
TTTGTGATCACTCACGCTATCATG	CTCaCGGAGGAGGAGTACG	CGGAGCTCACGGAGGAGGAGTACGAGGCCC	SLC9A8_p.T510A
TTTGACATGCTCTCTCTCGCACGA	CAGGaAGCTGAATGTCCAG	CGGAGCAGGAAGCTGAATGTCCAGAGGATG	ZNF462_p.E1441G
TTTGCACTCATCACATACACATCG	CAGCaGCGGCGGCGGGAGA	CGGAGCAGCAGCGGCGGCGGGAGAAGGCTG	GLTSCR2_p.Q341R
TTTGCTACTCTAGCTCACATCAGC	ACTaTGACCCAGATGAATG	CGGAGACTATGACCCAGATGAATGTGGGAG	EPB41L3_p.Y240C
TTTGTCACTCTACACAGATCACAT	AGCGaGGCGGGCCTCCTGG	CGGACAGCGAGGCGGGCCTCCTGGAGGCAG	PLCL1_p.E62G
TTTGTCGTCATCAGCTCAGCTACA	TTaTTGGAGAAGGTACTTA	CGGAATTATTGGAGAAGGTACTTACGGACA	CDK13_p.I711V
TTTGGCTACACACACACTGCACTC	GCAGCaGTGGGGGCTACAG	CGGAAGCAGCAGTGGGGGCTACAGAGGTGG	KRT1_p.S584G
TTTGTGCATCATACACAGACTCGT	GCaCTGCTTCGGGTAGAGC	CGGAAGCACTGCTTCGGGTAGAGCTGGGGC	PLD2_p.H818R
TTTGAGCTACACGCTCACTCGTCT	GGCTaTGTGACGCTGCTGG	CGCTTGGCTATGTGACGCTGCTGGAGGAAA	PTDSS2_p.Y78C
TTTGTCTCAGTCTATCTCTACGCA	TCCAaACTGAACGCCGAGG	CGCTGTCCAAACTGAACGCCGAGGTGGCCT	GTF2IRD1_p.K47R
TTTGCGATATCTACATCTGTCATC	TCCAaACTGAACGCCGAGG	CGCTGTCCAAACTGAACGCCGAGGTGGCCT	GTF2IRD1_p.K47R
TTTGCACTATATCATACTATCTGC	CCCCaCTACCTGGGCGCTC	CGCTGCCCCACTACCTGGGCGCTCTGGAGC	CERCAM_p.H48R
TTTGCTATAGTCATCACAGCACAT	CCCCaCTACCTGGGCGCTC	CGCTGCCCCACTACCTGGGCGCTCTGGAGC	CERCAM_p.H48R
TTTGACGCTATATCATCACTCTGC	TCCaCGGCACCCCCACTGC	CGCTCTCCACGGCACCCCCACTGCAGGCTG	SLX4_p.H588R
TTTGTCATGATACTCATACTCACT	TACGaTAGGCAGGGGCAGC	CGCTCTACGATAGGCAGGGGCAGCCGGTGG	EBF3_p.D76G
TTTGGACATCATCACATCGTCATA	GAGGCaATGCCTCTCGCTG	CGCGTGAGGCAATGCCTCTCGCTGCGGCCG	RTL1_p.Q1103R
TTTGTCTACTCACTACTGCTCACG	GCCCCaTGGGCTGCTACCC	CGCGGGCCCCATGGGCTGCTACCCGGGAGG	NFKB2_p.M395V
TTTGTCATCTGCACATCGTCACTC	CTTCTaCTGCGAGCGCCGC	CGCGCCTTCTACTGCGAGCGCCGCCGGCCC	CARD11_p.Y970C
TTTGGACACACTACACTGCTACGT	CTTCTaCTGCGAGCGCCGC	CGCGCCTTCTACTGCGAGCGCCGCCGGCCC	CARD11_p.Y970C
TTTGCACTCGCTATCTCGCTATCA	GCCGaGCGCCGCGGAGCGC	CGCGAGCCGAGCGCCGCGGAGCGCAGGACC	SOBP_p.S683G
TTTGATCTAGTCAGTCTCATCGAG	GCCGaGCGCCGCGGAGCGC	CGCGAGCCGAGCGCCGCGGAGCGCAGGACC	SOBP_p.S683G
TTTGCATACTCTATATATCTCACT	GCaGCTACTGGAGCGCGTG	CGCGAGCAGCTACTGGAGCGCGTGCGGCGC	HSF4_p.Q112R
TTTGCTCACTATGTCACTACTATA	GCaGCTACTGGAGCGCGTG	CGCGAGCAGCTACTGGAGCGCGTGCGGCGC	HSF4_p.Q112R
TTTGTAGCATCGATCACACTCTCT	ACTCaGCCCTCAGCTGGAG	CGCGAACTCAGCCCTCAGCTGGAGCGGCTC	SPIRE2_p.S122G
TTTGGATCACTGCTCTCATCTAGA	TTGaCTATGCCACCAAGAA	CGCCTTTGACTATGCCACCAAGAAGGGGCG	IDH3B_p.D203G
TTTGTCTCGCACATCTACATCTCG	ACCCCaAGAGGAGGAGGAG	CGCCTACCCCAAGAGGAGGAGGAGGGGCCG	SRCAP_p.Q2358R
TTTGTCTATCACTCACTATGCTCT	TGGATaGAGCAGGAGGGGC	CGCCGTGGATAGAGCAGGAGGGGCCGGAGT	HLA-A_p.I76M
TTTGCGCTCACATATAGTCTCATC	TGGATaGAGCAGGAGGGGC	CGCCGTGGATAGAGCAGGAGGGGCCGGAGT	HLA-A_p.I76M
TTTGCGCTACTACTACTCTATCTC	CGCaTCGGCTCCGGGCTCA	CGCCGCGCATCGGCTCCGGGCTCAAGGCGC	C2ORF54_p.I239V
TTTGTACATCACAGCATCACTATG	TGCaCTAATCAGCCTCGAG	CGCCCTGCACTAATCAGCCTCGAGAGGGAC	MBLAC1_p.H266R
TTTGCTCTGTCTACTCTCATATGT	GGCaCCCGCGTCCGCGCCA	CGCCCGGCACCCGCGTCCGCGCCATGGCCA	TP53_p.T155A
TTTGTCTCATCGTCATCACATCAG	GGCaCCCGCGTCCGCGCCA	CGCCCGGCACCCGCGTCCGCGCCATGGCCA	TP53_p.T155A
TTTGTCACACAGCACGTCACTCAC	GCGCaCGCCCTGGGCGGCA	CGCCCGCGCACGCCCTGGGCGGCATGGACG	CITED4_p.H127R
TTTGTGCTCTATATCTATCTCACA	AGCaCCAGGTTGTCCACAC	CGCCCAGCACCAGGTTGTCCACACAGGGGC	ZSCAN22_p.H314R
TTTGCTAGCTCAGCTACATCATCT	TGTaCTTGAACTACTGTCG	CGCCATGTACTTGAACTACTGTCGTGGGCT	CSNK1A1L_p.Y259C
TTTGCGCACATCGTCAGTCTACTA	TCAaCAAAGTGGTCTACAA	CGCCATCAACAAAGTGGTCTACAAAGGGGG	COL6A3_p.N1707S
TTTGTATCATCACACTATGTACTA	CTGaCAAAGCCCCCCGAAA	CGCCACTGACAAAGCCCCCCGAAAAGGGCA	MCF2L_p.T1007A
TTTGTCTCAGCTACACTCTCGTAT	CTGaCAAAGCCCCCCGAAA	CGCCACTGACAAAGCCCCCCGAAAAGGGCA	MCF2L_p.T1007A
TTTGGCATACATCACAGTCGTCGA	CTGGaGGGGGACCTGTCCC	CGCAGCTGGAGGGGGACCTGTCCCTGGCCG	AHNAK2_p.E1641G
TTTGACACTCTACAGCACGTCATC	CGGTaCCCGATGACCATGC	CGCAGCGGTACCCGATGACCATGCAGGGCC	ARID1A_p.Y430C
TTTGATACACATAGTCACTCTACA	CGGTaCCCGATGACCATGC	CGCAGCGGTACCCGATGACCATGCAGGGCC	ARID1A_p.Y430C
TTTGGCACATCTACATATCTATAC	CCGCaGCCCCCTGCTCCGG	CGCAGCCGCAGCCCCCTGCTCCGGAGGCTG	ACAT1_p.S16G
TTTGGCTACACATACTACAGTCTC	ACaGTGGAGCTGTTCATGA	CGCAGACAGTGGAGCTGTTCATGATGGAAG	TRRAP_p.T1551T
TTTGATGCTCATACATCATACGCT	AATCaTATTGTTGCAGCGA	CGCAGAATCATATTGTTGCAGCGATGGTTC	MYO9A_p.I1024V
TTTGTACGTCATCACATCTATGTA	AAGaAGCTCCTGAGTAAGA	CGCAGAAGAAGCTCCTGAGTAAGATGGCGT	TNFAIP8L1_p.K16E
TTTGTGCTACACTCACATCGATAT	AAGaAGCTCCTGAGTAAGA	CGCAGAAGAAGCTCCTGAGTAAGATGGCGT	TNFAIP8L1_p.K16E
TTTGAGCTCACACATCTAGCGTCA	TGTGTaTGAACTACTGTCT	CGATTTGTGTATGAACTACTGTCTTGGGTA	MACF1_p.Y590C
TTTGATGCACACTCACTATATCTA	TGTGTaTGAACTACTGTCT	CGATTTGTGTATGAACTACTGTCTTGGGTA	MACF1_p.Y590C
TTTGGCAGCTCACACTACACAGTA	GCCaCTACATTGACGTGAA	CGATTGCCACTACATTGACGTGAAGGGCAC	PHYH_p.H288R
TTTGGTCACTCTCACTAGCACAGT	CAGTaGAAGGTCAAGCAGT	CGATTCAGTAGAAGGTCAAGCAGTTGGTAA	LRMP_p.R344G
TTTGCTCATCTCTGCTCACTCAGC	GTGaCCGTGCTTTTGGGGA	CGAGGGTGACCGTGCTTTTGGGGAAGGCTG	NLRC5_p.T224A
TTTGCATACACATGCACACTCGTA	CCTaCCCTGCCTGCAGCCC	CGAGGCCTACCCTGCCTGCAGCCCTGGCAA	WFS1_p.Y739C
TTTGTACACACGATCATCATATAC	GACTCaTCACTGACCCGGC	CGAGCGACTCATCACTGACCCGGCCGGCGA	HS3ST2_p.I278V
TTTGATAGTCTATCTAGTCACATC	TCTaCAATGGGAAGGTAGC	CGAGATCTACAATGGGAAGGTAGCTGGCAG	KIF2C_p.Y405C
TTTGGTCACATGCTCTCTACTAGC	CCCaGGACCTGAATGGGGA	CGAGACCCAGGACCTGAATGGGGATGGGCT	CGREF1_p.Q126R
TTTGACAGCTCTCATCTGCTCGCT	GCCTCaGGTGCGCGGCGCA	CGACTGCCTCAGGTGCGCGGCGCAGGGAGC	COIL_p.R82G
TTTGGACAGCACATCGCTACAGTA	ACCCCaGAAACGCGGCGGG	CGACGACCCCAGAAACGCGGCGGGAGGCTG	PARK2_p.R89G
TTTGCTGCACACTCATATCTATAT	TCGaCCGCAACCGCCTGGG	CGACCTCGACCGCAACCGCCTGGGCGGCTT	LRRC10B_p.D190G
TTTGGCTCTATCATCTAGACACGC	CCCaGCTGGTAAGGAACTG	CGACCCCCAGCTGGTAAGGAACTGTGGGCT	KIAA0467_p.Q2423R
TTTGACGCTATCACGTCTATCACT	GCGGCaGCGAGCGCGGCGG	CGACAGCGGCAGCGAGCGCGGCGGCGGCGG	PURB_p.S8G
TTTGGACTATCATCACAGTCACGT	CGAACCCCGTAGCCAGGCT	CGAAGCGAACCCCGTAGCCAGGCTAGGATA	NT_nontargetX
TTTGCAGACTCTACACACTCACGC	TCCTaTGCCATTAAGAAGA	CGAACTCCTATGCCATTAAGAAGAAGGACG	RPS5_p.Y188C
TTTGGAGACACATATCACGTCTGC	TCAGGaGGGCCTGAGGCTA	CCTTTTCAGGAGGGCCTGAGGCTATGGCAG	GLE1_p.E145G
TTTGCTCAGTCTCACTACTATCGT	GCaGGAGCTGCCTGAGAAA	CCTTTGCAGGAGCTGCCTGAGAAATGGAAC	DNAH9_p.001
TTTGTAGCTCTATCACTATATCTC	GCaGGAGCTGCCTGAGAAA	CCTTTGCAGGAGCTGCCTGAGAAATGGAAC	DNAH9_p.001
TTTGCTATCTAGCATCACACTGCA	GCTCTaGCCCTAAAAAAGG	CCTTGGCTCTAGCCCTAAAAAAGGGGGAAA	DSN1_p.S58G
TTTGCACGTCTATCTATCACATGT	CTGTGaTGTTAGGAAATAA	CCTTGCTGTGATGTTAGGAAATAAAGGTTA	ANKRD13C_p.M153V
TTTGTATGCTCTATCATGCACTAG	CCAaCCACAGGCATGCAGA	CCTTGCCAACCACAGGCATGCAGAAGGCTG	NPR2_p.T699A
TTTGCGATCATCACAGTCATATAT	GACaTCCCGCCGCCCCCGA	CCTTCGACATCCCGCCGCCCCCGATGGACG	PGAM2_p.I121V
TTTGGTCAGCTACACGTCACTCGC	GACaTCCCGCCGCCCCCGA	CCTTCGACATCCCGCCGCCCCCGATGGACG	PGAM2_p.I121V
TTTGACTATCACATATCTCATCTC	CATaCTATTTCCATGGCTG	CCTTCCATACTATTTCCATGGCTGTGGGCA	GLDN_p.Y367C
TTTGCATAGCTCTCTCACGCACAC	AGCCaGAGACACCACCTGG	CCTTCAGCCAGAGACACCACCTGGAGGTGC	ZNF498_p.Q414R
TTTGATATACAGCTACACATCATG	ACGaGAGCCGCGAGGGCAG	CCTTAACGAGAGCCGCGAGGGCAGCGGCCG	PITHD1_p.E45G
TTTGCGCACGCACACTACACACAG	CTCCCaGCCGTACCAGCGA	CCTGTCTCCCAGCCGTACCAGCGAGGGCTC	CADPS_p.S36G
TTTGAGCGCTCACTACACTCACAC	CCaCCTGCTGTGAGAAGTT	CCTGTCCACCTGCTGTGAGAAGTTCGGCCT	VAV1_p.T81A
TTTGCAGTATACATCATCATCGTG	ACGGaCCGCAGTTTGTCCC	CCTGTACGGACCGCAGTTTGTCCCCGGACC	LHX5_p.D138G
TTTGATAGACACTCATACTATCAC	CCCaGGTAGGTGTCCCCAG	CCTGGCCCAGGTAGGTGTCCCCAGGGGTCC	C10ORF93_p.Q919R
TTTGAGCTACACACTACACTGTCG	AGCaGGCGCTGCGGAGGTG	CCTGGAGCAGGCGCTGCGGAGGTGAGGGCC	EFCAB4A_p.Q198R
TTTGCGCTCGTCTACTCTATCTGT	ACTCTaTGGGATAGAGCGG	CCTGGACTCTATGGGATAGAGCGGCGGCGA	SMG9_p.Y12C
TTTGGCAGTCTACTCATCACATAC	AACGCaTGGTGGTGCTGCA	CCTGGAACGCATGGTGGTGCTGCATGGATA	CYP2C19_p.M74V
TTTGTACACATCACTCTACTAGCA	TTCGaCAGGCTGCTCCACC	CCTGCTTCGACAGGCTGCTCCACCCGGACG	IL17RC_p.D706G
TTTGAGCTACACATATAGTACACA	TGCaGGCTCAGCCGGAGAT	CCTGCTGCAGGCTCAGCCGGAGATGGGCCC	KIF13B_p.001
TTTGAGCTCACTCATCTCATATGA	TGAaCTCGCTGGCGGCCTA	CCTGCTGAACTCGCTGGCGGCCTATGGCTG	RFTN1_p.N395S
TTTGGCGCTCACATCTACACACGA	GGAAGaAGGTGCTTCTCCG	CCTGCGGAAGAAGGTGCTTCTCCGGGGCTT	NOD1_p.K346E
TTTGACACAGCACACATCACAGCA	GGAAGaAGGTGCTTCTCCG	CCTGCGGAAGAAGGTGCTTCTCCGGGGCTT	NOD1_p.K346E
TTTGCATGCTCTACTCACACAGCA	GCCCCaGAGCCAGGCACCT	CCTGCGCCCCAGAGCCAGGCACCTGGGGGC	ATOH8_p.Q133R
TTTGCACTGACACATCTCTATCAC	CCTGGaTGGCTGCCTGCGC	CCTGCCCTGGATGGCTGCCTGCGCCGGGAT	SHBG_p.D191G
TTTGGTCATATCTCATCTAGCTAT	CATGaCACTGTCACTGTGC	CCTGCCATGACACTGTCACTGTGCTGGGCC	GPR114_p.D455G
TTTGTATATCTCACTGCGCGTCAC	GATTCaGGGGATCTTTGAC	CCTGAGATTCAGGGGATCTTTGACAGGGAT	NRBF2_p.Q121R
TTTGATCATGCATCGTCACATCGA	GATTCaGGGGATCTTTGAC	CCTGAGATTCAGGGGATCTTTGACAGGGAT	NRBF2_p.Q121R
TTTGTCGATCATATCTACTACTCT	AGGaCAAGGTGAGCGGCTC	CCTGAAGGACAAGGTGAGCGGCTCTGGACT	HEPACAM_p.D315G
TTTGCTACGTCACACTCTACACAC	GCCCaGCTCCAGGACGTGG	CCTCTGCCCAGCTCCAGGACGTGGTGGTGA	ILDR1_p.Q52R
TTTGAGATCTCACACTACGTACTC	CTCaAAACCCTCATCTTGG	CCTCTCTCAAAACCCTCATCTTGGAGGGCT	PRAMEF1_p.K107E
TTTGCTCAGTACATACTCTACAGC	GCTCTaCGGAGTGCACCTT	CCTCGGCTCTACGGAGTGCACCTTGGGCCA	CPNE6_p.T110A
TTTGGACTCACGTCTACACTACTC	CTGTaCCCGTCCATCATGA	CCTCGCTGTACCCGTCCATCATGATGGCCC	POLD1_p.Y607C
TTTGACTCTCTAGTCTACACATAC	CTGTaCCCGTCCATCATGA	CCTCGCTGTACCCGTCCATCATGATGGCCC	POLD1_p.Y607C
TTTGTCACACATCGCTCTCACAGA	ATGGCaTTCCCTTCCGTGG	CCTCGATGGCATTCCCTTCCGTGGTGGCCC	VWA2_p.I413V
TTTGGTACTCTCACTACACATCGA	AGGGaAAGCAGCAAGCCCC	CCTCGAGGGAAAGCAGCAAGCCCCGGGCTG	PPP2R2C_p.E380G
TTTGTGCGTCACACTCACTCACTG	AGGGaAAGCAGCAAGCCCC	CCTCGAGGGAAAGCAGCAAGCCCCGGGCTG	PPP2R2C_p.E380G
TTTGCACACGTCTATCATACACAT	TGGaTGAGATAGACTTACT	CCTCCTGGATGAGATAGACTTACTGGGTAA	GADL1_p.D328G
TTTGAGTCAGCACACTCTACGCAT	CGCTATTGAAACCGCCCAC	CCTCCCGCTATTGAAACCGCCCACAGGTTG	NT_nontargetX
TTTGGATCACACGATCACTACTAC	CACaAGATCCTGGTGTCAG	CCTCCCACAAGATCCTGGTGTCAGAGGACA	LRP5L_p.K69E
TTTGCACATCTACATATATCAGCA	GCCaAGTCCCTTTTGACCA	CCTCAGCCAAGTCCCTTTTGACCATGGAAT	FAM63A_p.K44E
TTTGTCTCACTCTGCATCAGTCAG	GCAGCaTCACAGGATCCTC	CCTCAGCAGCATCACAGGATCCTCCGGCTC	Q6ZSY1_p.H534R
TTTGTACACTATACTCTATCATAG	GGTaTGGCACTAAAAGCAG	CCTATGGTATGGCACTAAAAGCAGTGGGAG	CPNE8_p.M342V
TTTGTGTACGACACATCACTACAT	GACCaCACACCCGGCATGG	CCTACGACCACACACCCGGCATGGCGGGCT	IRX5_p.H89R
TTTGTCGATACATCTATCACAGCG	CCCCTaTGGCTGCTTTCTG	CCTACCCCCTATGGCTGCTTTCTGCGGAAA	ADAM15_p.M420V
TTTGCATCACTCTCTATCACATGC	ATCCaCGATCCCGAGAAGG	CCTACATCCACGATCCCGAGAAGGTGGCCG	ZC3H3_p.H692R
TTTGACTCTCTCTCATAGTCACAG	ATCCaCGATCCCGAGAAGG	CCTACATCCACGATCCCGAGAAGGTGGCCG	ZC3H3_p.H692R
TTTGACATGCGCTCACTCTCATCG	ATCGaTGAGGAAGAAATGA	CCGTTATCGATGAGGAAGAAATGATGGAGT	LOXHD1_p.D1599G
TTTGCAGTCTACATCTCATCAGTC	GCAaGTTGGACTGGGCTGA	CCGTGGCAAGTTGGACTGGGCTGAGGGCCC	FAM160A2_p.K847R
TTTGAGATCACTAGCTACTATCAG	GCAaGTTGGACTGGGCTGA	CCGTGGCAAGTTGGACTGGGCTGAGGGCCC	FAM160A2_p.K847R
TTTGTACTATCTAGTCTCACATCA	GAGCGaGGTGGTGCGGGGC	CCGTGGAGCGAGGTGGTGCGGGGCCGGACG	SDK1_p.E1265G
TTTGCACATGCTACTACTCTATCT	CCCaTCGCCACCTACTCCG	CCGTGCCCATCGCCACCTACTCCGTGGTGC	GPR153_p.I61V
TTTGGATCTACTCTGCTAGTCACA	GCCGaCTGCCTGCTCAGCA	CCGGTGCCGACTGCCTGCTCAGCAAGGAGC	BEND3_p.D552G
TTTGACTAGTATCTATCACACTCT	TTGTaTCACCGTCCAGGTG	CCGGGTTGTATCACCGTCCAGGTGAGGCTT	TCTA_p.Y68C
TTTGAGACACTACTCATCTATCAT	ACTaCTGCGTGCTGGGCGC	CCGGGACTACTGCGTGCTGGGCGCTGGGCC	FOXRED2_p.Y33C
TTTGTATCTAGCTCTACAGACTCA	ACTaCTGCGTGCTGGGCGC	CCGGGACTACTGCGTGCTGGGCGCTGGGCC	FOXRED2_p.Y33C
TTTGCTAGTCATCTCATCTCTAGA	GACaCCCACCTGGGCGGTG	CCGGCGACACCCACCTGGGCGGTGAGGACT	HSPA2_p.T229A
TTTGGACACGCTCGCTCTATCGCT	CTGaGCGCTGGCTGCGGAA	CCGGCCTGAGCGCTGGCTGCGGAAAGGAGA	CYP27C1_p.E292G
TTTGGTCACTCGCTCTACTCTCAG	ACCaCCGACGCCGCGCACC	CCGGCACCACCGACGCCGCGCACCCGGGGC	ALPP_p.T505A
TTTGATCAGCTACATACGTCAGTA	GTaTTGAGGTGAGAAGGCG	CCGGAGTATTGAGGTGAGAAGGCGAGGACT	L3MBTL2_p.I7V
TTTGCTAGCTACTGCTCTATCACA	GCTaCTTGCAGGCCAGCGC	CCGCTGCTACTTGCAGGCCAGCGCAGGAGA	CD226_p.Y223C
TTTGCATAGCATATACTCATACAC	CTGCaACCCCTGCTGCACA	CCGCCCTGCAACCCCTGCTGCACACGGTGA	IL17RD_p.Q500R
TTTGGCACACTACGCACTCTACTA	TCTaTGGGGAGGTCAGCAA	CCGCATCTATGGGGAGGTCAGCAAAGGATG	FXR2_p.Y275C
TTTGGACACTATCTACTCTCTAGT	TCaCCTTCAGCAACCTGTG	CCGCATCACCTTCAGCAACCTGTGTGGCTG	ANKRD13D_p.T336A
TTTGCATCACTCGCTACTATCGCG	CCCaGTGCGTGGTGGTCGC	CCGCACCCAGTGCGTGGTGGTCGCCGGCTC	LPHN1_p.Q101R
TTTGTAGCTACATCAGTCTATCGA	ATGCCaGAGCCCAGTGTGT	CCGCAATGCCAGAGCCCAGTGTGTTGGCTG	GPR115_p.R346G
TTTGTCTCACTCAGTAGTCACATC	GGCaAAGGCCCCAGCATCT	CCGATGGCAAAGGCCCCAGCATCTGGGATA	LCT_p.K927E
TTTGACATCTCTCAGTCATCGCTC	CTCCaGCAGCCAGTGGGGC	CCGAGCTCCAGCAGCCAGTGGGGCGGGCGC	PLIN4_p.Q1213R
TTTGTATATATAGTCTCACATACA	ACCaTTCACGCCGACAGCG	CCGAGACCATTCACGCCGACAGCGTGGCCA	SEPX1_p.I50V
TTTGGAGCACGCACACTCTCACTG	TCAGaTGCTGAGGTTGCAG	CCGACTCAGATGCTGAGGTTGCAGAGGCTG	KIAA1467_p.D63G
TTTGATCTATCACAGTACACATCG	GCCCaGGGCCGGGCGTCCG	CCGACGCCCAGGGCCGGGCGTCCGAGGACA	DIDO1_p.Q2106R
TTTGATACACATCGATACATACTC	GCAaTGGCAGCCTTTGCAG	CCGACGCAATGGCAGCCTTTGCAGTGGAAC	NUP35_p.M1V
TTTGTAGCTCGCACTCATACTCTG	GACGaCAACACCTACAGCC	CCGACGACGACAACACCTACAGCCTGGAGC	B3GAT1_p.D197G
TTTGGATCACTACACTCACTATGT	GACGaCAACACCTACAGCC	CCGACGACGACAACACCTACAGCCTGGAGC	B3GAT1_p.D197G
TTTGTCTATCAGCTCACGCTATCT	GGGGaCAGCTTCCCGCTGA	CCGAAGGGGACAGCTTCCCGCTGATGGAGA	ANO9_p.D16G
TTTGTACACTCGTCACACGTCACA	TGGAaGGACCAGGCGCTGG	CCCTGTGGAAGGACCAGGCGCTGGTGGAGA	NOS1_p.K631R
TTTGTCATCATACTACAGTACATC	TGGAaGGACCAGGCGCTGG	CCCTGTGGAAGGACCAGGCGCTGGTGGAGA	NOS1_p.K631R
TTTGTACGCACACACTCTGCTCGT	CAGCaGCTGCAGCGAGACC	CCCTGCAGCAGCTGCAGCGAGACCTGGGCC	GPX7_p.Q69R
TTTGGTATCATCATACGCACTCTG	CAGCaGCTGCAGCGAGACC	CCCTGCAGCAGCTGCAGCGAGACCTGGGCC	GPX7_p.Q69R
TTTGAGTATCACTACTCACTCTAT	GGGGaCCCTTCGTGTCCGG	CCCTCGGGGACCCTTCGTGTCCGGTGGTTG	ADAM9_p.T11A
TTTGCACTCGCACTACATACACGC	CACaGAACGTCATCGCCAG	CCCTCCACAGAACGTCATCGCCAGCGGTCG	SDK2_p.Q695R
TTTGGCTCACACTGCTACACATCA	ATGaCCTTCTTCCTGGCCC	CCCTCATGACCTTCTTCCTGGCCCTGGGAC	SLC29A2_p.T435A
TTTGAGTCATCTCTGCTCAGTCAG	GCATCaCTGTCCTGGTAAC	CCCTAGCATCACTGTCCTGGTAACTGGGGC	AACS_p.T376A
TTTGGACATACACATCTCGCTCTC	ACGCTTGCGTTTAGCGTCC	CCCGTACGCTTGCGTTTAGCGTCCAGGTCC	NT_nontargetX
TTTGATGACACGTCTACACACTCT	TGCATaCAGGGTGAGTGGC	CCCGGTGCATACAGGGTGAGTGGCGGGCGC	ANK1_p.T911A
TTTGTCTACTCTCATACACTCATC	TGCATaCAGGGTGAGTGGC	CCCGGTGCATACAGGGTGAGTGGCGGGCGC	ANK1_p.T911A
TTTGACTCTCACTACACAGTCACT	GAGaAGCACTCGGGCCGCC	CCCGGGAGAAGCACTCGGGCCGCCAGGTGG	PAK6_p.K427E
TTTGAGCTATCTATCATCTGCATA	CGCCaCCTATGTATGGTCA	CCCGGCGCCACCTATGTATGGTCATGGAAT	MAST3_p.H439R
TTTGTCTCACTCTATACTCACACT	AGGaCGGCGAGAGGCCGAG	CCCGGAGGACGGCGAGAGGCCGAGCGGGAG	KCNG4_p.D319G
TTTGGACTACTACTCACGTCACTC	AGCTCaCAGCTGCCTGCCT	CCCGGAGCTCACAGCTGCCTGCCTGGGCCG	ACTL7B_p.T319A
TTTGACTGCTCGCACTACTACTGC	TCAAGaACCTGCTGGCCGG	CCCGCTCAAGAACCTGCTGGCCGGCGGCTT	SLC25A20_p.N13D
TTTGCTGCTCACTATCATATCTCT	AGCaGTGCCCCTGCGGCCA	CCCGAAGCAGTGCCCCTGCGGCCACGGGCT	GREB1_p.Q941R
TTTGATGTCACTACAGCTCTGTCG	AGCaGTGCCCCTGCGGCCA	CCCGAAGCAGTGCCCCTGCGGCCACGGGCT	GREB1_p.Q941R
TTTGGCTCTACATCTCACATAGTA	CCTCaGCATCTTATCCGAG	CCCCTCCTCAGCATCTTATCCGAGTGGAAG	TP53_p.Q192R
TTTGGTCTCTCTACTCTCACGTCA	CCTCaGCATCTTATCCGAG	CCCCTCCTCAGCATCTTATCCGAGTGGAAG	TP53_p.Q192R
TTTGTGTCACAGCATATCACACGT	TCCaTGGACCGCGCGGCCG	CCCCGTCCATGGACCGCGCGGCCGTGGCGA	NT5C3_p.M6V
TTTGTCACAGTCTCACATATCAGA	TGTGaCGAGGTGGGCAGCT	CCCCCTGTGACGAGGTGGGCAGCTGGGCGG	RASGEF1C_p.D145G
TTTGAGCATCACACTGTCTACACA	GTaCTGCGATGGCACCCAC	CCCCCGTACTGCGATGGCACCCACAGGAGT	CISD3_p.Y108C
TTTGTCAGCATCTCTATCTCACGT	CTCGTaCACAGCTGGGCAG	CCCCCCTCGTACACAGCTGGGCAGAGGAAG	BRF1_p.Y179C
TTTGTGACATCTACACTCGTCGAT	CAGaAGAAGATAAAGAGCG	CCCCACAGAAGAAGATAAAGAGCGAGGCGT	MYCN_p.K348E
TTTGTCATCTCACACTACTCTACG	CAGaAGAAGATAAAGAGCG	CCCCACAGAAGAAGATAAAGAGCGAGGCGT	MYCN_p.K348E
TTTGGTATGCACACACACTATCTA	TGCTaAGGTGTCAGGCCCA	CCCATTGCTAAGGTGTCAGGCCCAAGGGGA	ATP1A4_p.K452E
TTTGGTCATACGCACACACTCGCT	CTaGAACCGCCGCTGGCAC	CCCATCTAGAACCGCCGCTGGCACTGGAGC	REG1A_p.001
TTTGATCAGCACATCTATCTCTAC	GTGTaTGAGCTGCTAGAGA	CCCAGGTGTATGAGCTGCTAGAGAAGGACT	ABL1_p.Y449C
TTTGCATATCATCATCATCTATAG	GTGTaTGAGCTGCTAGAGA	CCCAGGTGTATGAGCTGCTAGAGAAGGACT	ABL1_p.Y449C
TTTGACATCATCTACACGAGACTA	GCTTGaGTGGAGAAGCTGT	CCCAGGCTTGAGTGGAGAAGCTGTTGGTAC	GOLGA6L10_p.S445G
TTTGGCTCTAGCACACTCAGTACA	GCCGaGTTGGATGACAAGC	CCCAGGCCGAGTTGGATGACAAGCAGGCGG	DNAH5_p.E3450G
TTTGGCACATCTGCACTACACTCA	ACCaAGGATGCAGAAACAG	CCCACACCAAGGATGCAGAAACAGGGGAGG	CHD6_p.K387E
TTTGCTGTCATCTATCATCTGATC	CGGCGaAGTGCAGTGGCGC	CCCAACGGCGAAGTGCAGTGGCGCAGGGCC	TRIM56_p.E578G
TTTGTCATCTCACTCACGCTACGC	CACCaCGTTGGGGGAAGAA	CCCAACACCACGTTGGGGGAAGAAAGGCAG	SLC22A7_p.T93A
TTTGATCTAGCACTACTCTCACGA	CACCaCGTTGGGGGAAGAA	CCCAACACCACGTTGGGGGAAGAAAGGCAG	SLC22A7_p.T93A
TTTGACTCTCACAGCACTCTACAT	AACAaTGGATATGTATGCC	CCATTAACAATGGATATGTATGCCTGGACT	MFSD8_p.M295V
TTTGCATCTATGTACACACATACG	CGGGaGGAGGTGGCCAAGC	CCATCCGGGAGGAGGTGGCCAAGCTGGCCA	C11ORF41_p.E1832G
TTTGAGTCTACATCATATACACAT	CCCCaCAGGTAAGGCCCCA	CCATCCCCCACAGGTAAGGCCCCATGGAGC	CYP1A1_p.H388R
TTTGCATGTCACAGCTCATACTAC	AGGaGTGGCCTTGATGACG	CCATCAGGAGTGGCCTTGATGACGTGGAGG	MKRN2_p.S153G
TTTGCGAGTACACATCACACTAGT	ACCTaTGGCTACTACAATA	CCATCACCTATGGCTACTACAATAAGGTAC	DENND4B_p.Y739C
TTTGCTATCATCATCGTACTACTC	GTTACaGAGGGCTAGGAGG	CCATAGTTACAGAGGGCTAGGAGGGGGTCT	NOL4_p.R559G
TTTGCACAGTCACATCTAGCTCAG	GTTACaGAGGGCTAGGAGG	CCATAGTTACAGAGGGCTAGGAGGGGGTCT	NOL4_p.R559G
TTTGATGCTCGCACATCATCGATA	CGAGaTGCAGAGCGTGTAA	CCATACGAGATGCAGAGCGTGTAAAGGAAA	CDC5L_p.D527G
TTTGCACTAGTCACTCAGTCACAC	GCGGCGTAATGCTTGAAAG	CCAGTGCGGCGTAATGCTTGAAAGAGGGGG	NT_nontargetX
TTTGCATCTCAGTACTCACTATCA	GCaCGGGAACCTTTGGCTA	CCAGTGCACGGGAACCTTTGGCTACGGCTA	DNAH10_p.T1789A
TTTGATACTCACTGCACTACACGC	CCCCCaACCGGCGCTACCC	CCAGTCCCCCAACCGGCGCTACCCAGGTCC	ELAVL4_p.N230D
TTTGGCACACACAGATCATCTATA	TGCTCaGCCTCAGTGCCCA	CCAGGTGCTCAGCCTCAGTGCCCACGGCGG	MAMDC4_p.S838G
TTTGAGACTCTCTCTACAGCATCG	GGAGCaGTTTAAGCCTGCC	CCAGGGGAGCAGTTTAAGCCTGCCCGGAGG	AGPAT3_p.Q298R
TTTGGACATACACTACTCTATGCT	GACGCaGGTGGGCACCGTG	CCAGGGACGCAGGTGGGCACCGTGTGGAGC	LRRC24_p.Q53R
TTTGAGTACATATCTGCTCGTCAC	CCCGCaATGCTGTGAGGAC	CCAGGCCCGCAATGCTGTGAGGACAGGTAA	SH3RF1_p.N588D
TTTGGACTCATCAGCATCATCATC	ACAGaCAGCCATGAGGCTC	CCAGGACAGACAGCCATGAGGCTCGGGCAG	RRP8_p.D229G
TTTGCGACTCTCTCATCGTACTAT	TCGGaGACTGAGATCCGCT	CCAGCTCGGAGACTGAGATCCGCTGGGCTG	AKNA_p.E5G
TTTGTGACTCATCTCAGCACACAG	TCCaCCAGCACTGGGGCTG	CCAGCTCCACCAGCACTGGGGCTGGGGCCA	RFX1_p.T370A
TTTGTGTCACTGCTCGCATATCGT	GCTGTaCAGCAGGTAATAG	CCAGCGCTGTACAGCAGGTAATAGAGGGGC	LRRC55_p.T262A
TTTGGTCTAGCTCACACTGTCGTA	CCAaCCCCTGTGAACACGG	CCAGCCCAACCCCTGTGAACACGGTGGGGA	HABP2_p.N80S
TTTGTCTGTCATCTATCAGCTATA	CATAGaTGTTTGGAGCTGT	CCAGCCATAGATGTTTGGAGCTGTGGGTAA	CDK12_p.D918G
TTTGCATGCATCTACATCACAGAT	CATAGaTGTTTGGAGCTGT	CCAGCCATAGATGTTTGGAGCTGTGGGTAA	CDK12_p.D918G
TTTGGCAGCACTACACTCGCATAT	CACCTaGGGATGTGAGTCT	CCAGCCACCTAGGGATGTGAGTCTTGGCTG	RP13-395E19.1_p.R55G
TTTGATATCACATATCACTGTACG	CACaTGCCCACGGGCCCGC	CCAGCCACATGCCCACGGGCCCGCAGGTGA	MYBBP1A_p.M959V
TTTGTAGCATCGTCACACACTACT	AAAGaATCTCCCCCACATG	CCAGCAAAGAATCTCCCCCACATGAGGACT	AGTPBP1_p.E124G
TTTGTACATACTCTGCTCTACAGT	GTCCCaCGCAGCCCAGTCC	CCAGAGTCCCACGCAGCCCAGTCCGGGGCC	EP400_p.T137A
TTTGGCAGCACTCTACTCTACATG	ACTaCGCCAAGGAGGTGGC	CCAGAACTACGCCAAGGAGGTGGCAGGGGT	RRBP1_p.Y1219C
TTTGATCATCGTCACATCACAGCG	AAGaCAGTGCCTCGGGCTG	CCAGAAAGACAGTGCCTCGGGCTGAGGAAG	TMC2_p.T292A
TTTGTACAGTCACATATCAGCTCA	AAACaTAAAAGAAAGCCTC	CCAGAAAACATAAAAGAAAGCCTCTGGGGG	EXDL2_p.H213R
TTTGACTGCTCTATCAGTCGATAT	TTAGCaTAGATCGAAATAC	CCACTTTAGCATAGATCGAAATACGGGAGA	PCDHA8_p.I295V
TTTGATACTACACGCACTCGCACG	TCAGaGCACCGGCTGGGCA	CCACGTCAGAGCACCGGCTGGGCAAGGACT	PLXNA4_p.E1786G
TTTGCTATCAGTACATCGATACAC	ACTaCCCCTCCGGGGCCTG	CCACGACTACCCCTCCGGGGCCTGGGGCCC	XIRP1_p.T1042A
TTTGACTACTCTACTACATCTCTA	CACTaCACAGCCAAGATCC	CCACCCACTACACAGCCAAGATCCAGGCAC	TNC_p.Y1951C
TTTGATCGCTGCATACATACTATC	CAAaGCCCTCCAGCCACCC	CCACCCAAAGCCCTCCAGCCACCCAGGGCT	ASAH2_p.S35G
TTTGTGCATCAGCTCTCACAGCGT	GGGTGaGCGTGGCCACCCT	CCAATGGGTGAGCGTGGCCACCCTGGGCCC	COL5A1_p.E1013G
TTTGCACTCACGTCTACTCATGCT	GGGTGaGCGTGGCCACCCT	CCAATGGGTGAGCGTGGCCACCCTGGGCCC	COL5A1_p.E1013G
TTTGGTCACACATCGTCTATATCT	GCCCaCATGCCTGTGCCCA	CCAATGCCCACATGCCTGTGCCCATGGAAA	KIAA0408_p.H500R
TTTGTATCTCAGCTACATCTCAGA	TTaTGGCCCCGCCCGTCCA	CCAAGTTATGGCCCCGCCCGTCCACGGCAA	SYNGAP1_p.Y1099C
TTTGTACTATCTACTACGCACGTC	TCCaGAGAGTGGGACATGG	CCAAGTCCAGAGAGTGGGACATGGAGGCCC	CKAP4_p.R303G
TTTGATAGCATCACTATCTACTCG	GTCaCTGTTGCCATGGCCA	CCAAGGTCACTGTTGCCATGGCCACGGCCC	HRG_p.H426R
TTTGTATGCACTCTCGCACTAGTA	GAGCaTGACAAGAGCGGCG	CCAAGGAGCATGACAAGAGCGGCGAGGAGG	PIEZO1_p.H1817R
TTTGGTACAGCATCACACTACAGA	GGCTCGTTCTACGCACTGA	CCAACGGCTCGTTCTACGCACTGAAGGTTT	NT_nontargetX
TTTGTCACTCTCACTCTATCGCTC	GCCAaTGAGCTCAAGTACC	CCAACGCCAATGAGCTCAAGTACCTGGACG	MYO9B_p.N1509S
TTTGTCATCATACTACATCAGCTA	TACaTCAAGATGTTTGTAC	CCAAATACATCAAGATGTTTGTACTGGATG	EIF4A1_p.I176V
TTTGCATCTATCATCTGCTATCAT	CGTaTCCCCCTGCGGAGAC	CCAAACGTATCCCCCTGCGGAGACAGGTAA	FGFR2_p.I333V
TTTGTATCACACATGTATACTCTC	CGTaTCCCCCTGCGGAGAC	CCAAACGTATCCCCCTGCGGAGACAGGTAA	FGFR2_p.I333V
TTTGACAGTATACACTCTCGCTCT	AGAGAaGGGGGATGGCAAA	CATTTAGAGAAGGGGGATGGCAAAGGGACC	PRR25_p.K201R
TTTGCACTACTAGCTATCGTCAGA	AGAGAaGGGGGATGGCAAA	CATTTAGAGAAGGGGGATGGCAAAGGGACC	PRR25_p.K201R
TTTGGTCAGCTCACTCATATCGAC	TATaCGTGTTCTGTGTGGG	CATTGTATACGTGTTCTGTGTGGGTGGAGA	PTPRH_p.T96A
TTTGGATACTCACACTACGTCATC	CCAACaTCCAGAGCGACAT	CATTGCCAACATCCAGAGCGACATCGGAGC	PGA3_p.I293V
TTTGGCTCGATCTACTACTCTACA	TTCaAAGGGCTGTATGTGA	CATTCTTCAAAGGGCTGTATGTGATGGGGA	PKHD1_p.K2781E
TTTGTACTCACTCTACAGTCAGTA	GTAaCaGTTCCTGCATGGG	CATGTGTAACAGTTCCTGCATGGGCGGCAT	TP53_p.N146S
TTTGGCAGTACACACACATCAGCG	GTAaCaGTTCCTGCATGGG	CATGTGTAACAGTTCCTGCATGGGCGGCAT	TP53_p.N146S
TTTGACTATCTCGCTACTACTCGC	CCTaCGTCATGGAGAAGGC	CATGGCCTACGTCATGGAGAAGGCTGGGGG	FBP1_p.Y287C
TTTGGACTCATCATCTCACTAGAT	ACTCCaCCTACGACCGGGC	CATGCACTCCACCTACGACCGGGCCGGCGC	PIAS4_p.T89A
TTTGGCTCTACACACTACACACTA	CGAGaGCGGCTTGAACAGG	CATGACGAGAGCGGCTTGAACAGGCGGCAC	SEPT2_p.S134G
TTTGATCACTACTCTGCGTACTAT	CGAGaGCGGCTTGAACAGG	CATGACGAGAGCGGCTTGAACAGGCGGCAC	SEPT2_p.S134G
TTTGCACATGTCTATCAGCACTAG	ACAaCCGGACCGTGCAGCA	CATGAACAACCGGACCGTGCAGCATGGCGT	CX3CR1_p.N140S
TTTGATATCTCGTCTATCTCATAT	TGCaGGCCCGGGCCTATGT	CATCTTGCAGGCCCGGGCCTATGTGGGACC	ATP13A2_p.Q377R
TTTGGTCTATCACACTATCATGTA	TCTaCCAGCTGCTGGCAGG	CATCTTCTACCAGCTGCTGGCAGGTGGCGA	MYO1H_p.Y206C
TTTGACTCTCATATCACACTACAC	GTCaAGGACAAATTTAATG	CATCTGTCAAGGACAAATTTAATGAGGCAC	TFIP11_p.K701E
TTTGGACTATCACAGCTACTACGT	GCGGaGTAAGTGTGGGCCC	CATCTGCGGAGTAAGTGTGGGCCCTGGCCC	SMTN_p.E868G
TTTGATATACACTCTACACGAGAC	TGTaTGTGTGTGAAGGATC	CATCCTGTATGTGTGTGAAGGATCAGGAAG	GPR52_p.M340V
TTTGCATCACACTCTCACTAGCAC	TGCGCaCCATGTGGTTCGC	CATCATGCGCACCATGTGGTTCGCCGGCGG	LPCAT1_p.T105A
TTTGTCACATACTACTACAGTCAG	GGAaGGCGGGGACCCTGCA	CATCAGGAAGGCGGGGACCCTGCACGGCTT	PRMT2_p.K332R
TTTGTCTCTGCTCACAGCTCTAGT	CCTCaAGTGTGTAGGTAAG	CATCACCTCAAGTGTGTAGGTAAGTGGGGC	CRELD1_p.K242E
TTTGTACTACATCAGTACAGCTAT	ATGTaCTTGAAGGATATAA	CATAGATGTACTTGAAGGATATAATGGAAC	KIF5B_p.V73V
TTTGCTATCACTGTATACACATCT	ATGTaCTTGAAGGATATAA	CATAGATGTACTTGAAGGATATAATGGAAC	KIF5B_p.V73V
TTTGGCTATCACTCTCTAGTATCT	GTGGCaGCAGAGGTGACAG	CAGTGGTGGCAGCAGAGGTGACAGCGGCAG	DMKN_p.S296G
TTTGGATCTACTACTCGTATCATC	GCTaTGGCGGTGGCCTCGG	CAGTGGCTATGGCGGTGGCCTCGGTGGAGG	KRT5_p.Y508C
TTTGTCACGTACTCACTCATCGCT	CCACTaTAGAGTATAATGA	CAGTCCCACTATAGAGTATAATGATGGAAG	APC_p.I2515V
TTTGTACTATCACTACTATCACTG	CCACTaTAGAGTATAATGA	CAGTCCCACTATAGAGTATAATGATGGAAG	APC_p.I2515V
TTTGAGACTCTACTCATAGTCAGC	TACaTCAGCAAACTCATAC	CAGTATACATCAGCAAACTCATACTGGAGA	ZNF615_p.H614R
TTTGATATCTCTGTCTATATCACA	GTCaACATGTTGTCCCCCG	CAGGTGTCAACATGTTGTCCCCCGGGGAGT	TNFRSF10B_p.N301D
TTTGTCAGATCATCTCACAGTATG	GTACaGCCTTGTGCCTGAC	CAGGTGTACAGCCTTGTGCCTGACAGGACC	STK19_p.S177G
TTTGCATATCATACATCGCGTACT	GGGaCGCTGCAGGCCCTAG	CAGGGGGGACGCTGCAGGCCCTAGGGGAGA	AMBRA1_p.D1197G
TTTGCTGTCTACACACACACATAC	GGGaCGCTGCAGGCCCTAG	CAGGGGGGACGCTGCAGGCCCTAGGGGAGA	AMBRA1_p.D1197G
TTTGACTGCATCACTACTCTAGAC	CAaGTGAGTGCAGCCACCC	CAGGGCAAGTGAGTGCAGCCACCCTGGACA	CABIN1_p.K1637R
TTTGATCACATGCTCACTCAGTAT	AGGGaAGCTGTGGGAGGCC	CAGGGAGGGAAGCTGTGGGAGGCCAGGAGG	APOBR_p.E439G
TTTGGTCACTATCAGTACACACTC	TTaCTGGCTGGGGGCCCCC	CAGGCTTACTGGCTGGGGGCCCCCCGGGAC	TBX21_p.Y385C
TTTGCACATCAGCGTCATCACAGC	TTaCTGGCTGGGGGCCCCC	CAGGCTTACTGGCTGGGGGCCCCCCGGGAC	TBX21_p.Y385C
TTTGCACACTCATACACGTCACTC	GGTGGaCAGGGACACCAAT	CAGGCGGTGGACAGGGACACCAATCGGCCA	CDH11_p.D132G
TTTGGTACTCATCATCACTAGATC	GATGaCGAGCCAGAGTACG	CAGGCGATGACGAGCCAGAGTACGAGGTGA	DNMT3A_p.D280G
TTTGTACTCTAGACTCACACACTG	GATGaCGAGCCAGAGTACG	CAGGCGATGACGAGCCAGAGTACGAGGTGA	DNMT3A_p.D280G
TTTGAGCACATCATCTGACTCACT	AGGaGGGAGCGAAGCCCAC	CAGGCAGGAGGGAGCGAAGCCCACCGGCGA	DUS1L_p.E320G
TTTGCTCTGCTCTACATCACATCG	ACCCCaAGCACCCCGGAGC	CAGGCACCCCAAGCACCCCGGAGCCGGGCA	MLL4_p.Q204R
TTTGTATACAGCATCATCTCTGAT	GTGaCGCTAGGGGCATTCG	CAGGAGTGACGCTAGGGGCATTCGGGGGAG	SIGLEC12_p.T478A
TTTGCTCTACTACGTACTCATACG	CTGCaGGGGTCCCCCTGAT	CAGGACTGCAGGGGTCCCCCTGATAGGCGT	WDR33_p.R997G
TTTGCTCTCACTGTCATCACAGTC	AGAGaGGATGGTGGCACAT	CAGGAAGAGAGGATGGTGGCACATTGGCTA	USP8_p.E144G
TTTGCATGACTCACTCTACTACTG	GTGCaGATGCACGATGTGC	CAGCTGTGCAGATGCACGATGTGCTGGTGA	TRRAP_p.Q3118R
TTTGTCTACTACATACACACGCAT	GTGCaGATGCACGATGTGC	CAGCTGTGCAGATGCACGATGTGCTGGTGA	TRRAP_p.Q3118R
TTTGCATCATCACTGCACGTCACG	GGCCaCCCAGTTTGAGAAC	CAGCTGGCCACCCAGTTTGAGAACTGGTAT	GUSB_p.T523A
TTTGTGACACTGCTACATCACGCG	GCGTTaCGAGCAGGAGCGG	CAGCTGCGTTACGAGCAGGAGCGGCGGCCC	SAFB2_p.Y721C
TTTGATATCATGTCACACTCAGTA	GCCaCGATCCGCATCGTGC	CAGCTGCCACGATCCGCATCGTGCAGGGAC	NFRKB_p.T1112A
TTTGTCTCACACTGTACTACACAC	TGTGTaCTGGTCTGACGTG	CAGCGTGTGTACTGGTCTGACGTGCGGACA	LRP1_p.Y1630C
TTTGCTGCTACGTATCATCTACAC	TGTGTaCTGGTCTGACGTG	CAGCGTGTGTACTGGTCTGACGTGCGGACA	LRP1_p.Y1630C
TTTGGTCACACACATAGCACACTG	CTGGaGAACACCTCCATCA	CAGCCCTGGAGAACACCTCCATCAAGGTGG	MAST3_p.E1038G
TTTGACTAGCTCTCATATCTGCTC	CAGGTaAGCGCGGCCCCGG	CAGCCCAGGTAAGCGCGGCCCCGGCGGGCT	SYT7_p.001
TTTGTGTCTACTATCTACATACGC	TCCATaGGTGGGTGAGGGC	CAGCATCCATAGGTGGGTGAGGGCGGGCGG	PRAM1_p.I477M
TTTGATATCTCTACTCTCAGTATC	GGTaCGAGGGGAAGTGCCG	CAGCAGGTACGAGGGGAAGTGCCGAGGTTC	MYO3B_p.T1141A
TTTGGATCATCTATGCTCTATATC	GGTaCGAGGGGAAGTGCCG	CAGCAGGTACGAGGGGAAGTGCCGAGGTTC	MYO3B_p.T1141A
TTTGCGATACATCTCACTCTACGT	GCCCAaCTGGGGGCCCAAG	CAGCAGCCCAACTGGGGGCCCAAGAGGACG	NRG1_p.T228A
TTTGATGACATCATATATCTATAG	GCCaCCCACCAGGCCGGGC	CAGCAGCCACCCACCAGGCCGGGCAGGCAC	CACNB1_p.H483R
TTTGCTCACACACTATCATCACTA	GCCaCCCACCAGGCCGGGC	CAGCAGCCACCCACCAGGCCGGGCAGGCAC	CACNB1_p.H483R
TTTGCTGCACTCTCATACTACAGA	GCAGCaGCAGCAGCAGCAG	CAGCAGCAGCAGCAGCAGCAGCAGAGGCAG	FAM155A_p.Q82R
TTTGTACTACACACTGCGCACTCA	GCAaCCTGAGCTGCGGCGG	CAGCAGCAACCTGAGCTGCGGCGGGGGCAG	MYT1L_p.N702S
TTTGGCACATCTGCATCATGTCAT	CGTGTaCGAGAAGAAGGTG	CAGCACGTGTACGAGAAGAAGGTGCGGCTG	AKT1_p.Y417C
TTTGTGACATCTACTCTAGTCAGC	CGTGTaCGAGAAGAAGGTG	CAGCACGTGTACGAGAAGAAGGTGCGGCTG	AKT1_p.Y417C
TTTGAGCACTCACATCTACGAGAC	CAACTaCATCCAGATGTAC	CAGCACAACTACATCCAGATGTACCGGCGC	LZTS2_p.Y621C
TTTGACACTGCTACTCGCTACAGT	CAACTaCATCCAGATGTAC	CAGCACAACTACATCCAGATGTACCGGCGC	LZTS2_p.Y621C
TTTGAGTACACATCATATCTAGAC	ACGaGGTCAAGGAGATCAA	CAGCAACGAGGTCAAGGAGATCAAAGGCTA	TGM7_p.E692G
TTTGATAGTCACTACATCGCACTA	TAaCAGCCATGCAACAGAA	CAGATTAACAGCCATGCAACAGAATGGAGT	MTFR1_p.N57S
TTTGTGAGTCACATCTCACTACAT	TAaCAGCCATGCAACAGAA	CAGATTAACAGCCATGCAACAGAATGGAGT	MTFR1_p.N57S
TTTGAGCACATCATGTACACACTC	GGCaCCCTCTCAGGTGGAG	CAGATGGCACCCTCTCAGGTGGAGAGGCAT	PLEKHG1_p.T720A
TTTGGTCTCACGTACTCTCATACA	GGCaCAGCCAAGGTGTGGC	CAGATGGCACAGCCAAGGTGTGGCAGGTGG	WDR86_p.T174A
TTTGCACTACTCTCACACGCGTCA	TTGCaCAAGATCAACCTGG	CAGAGTTGCACAAGATCAACCTGGTGGTGT	ABCC11_p.H528R
TTTGCTCATACTATCATCTCTACA	GACCaCCTCGCCTGGGGGC	CAGAGGACCACCTCGCCTGGGGGCCGGCCC	PLEKHG3_p.T1027A
TTTGGTCTCACATGCATCGTCATG	CGCaCCCGTTGGGCGATGA	CAGAGCGCACCCGTTGGGCGATGAAGGCGG	C8ORF33_p.H58R
TTTGCTACGTCATCACATATCGAT	CCTCaGGTGAGTGACCGAG	CAGAGCCTCAGGTGAGTGACCGAGCGGCCC	NLRC5_p.R1584G
TTTGTCATATCAGCACGCACTCTA	CAGaAAGACCATGGGTTTG	CAGAGCAGAAAGACCATGGGTTTGAGGTGG	CASP9_p.K292E
TTTGCTCTACACATCTCACACACA	GACaGATAGGGAAGCAAGA	CAGACGACAGATAGGGAAGCAAGAAGGGGG	MRPL32_p.Q140R
TTTGACTGCACTCGTCATCTCTGC	CTCaTGCAGCTCCAGAGTG	CAGACCTCATGCAGCTCCAGAGTGAGGTAG	MYH3_p.M1736V
TTTGAGCATCATATCAGTCTCTCG	CAAaGGATCGCCATCGACC	CAGACCAAAGGATCGCCATCGACCTGGTAA	SERPIND1_p.R431G
TTTGCTACTCACTCTATCTGCTAG	ATCaTGCGTTCAGTGGGCG	CAGACATCATGCGTTCAGTGGGCGAGGGTG	WNT2B_p.M74V
TTTGTGCTATCTACATACACATAC	ATCaTGCGTTCAGTGGGCG	CAGACATCATGCGTTCAGTGGGCGAGGGTG	WNT2B_p.M74V
TTTGAGACTCACACAGCACGTCTG	AGCTCaAAAATAACCTGAA	CAGACAGCTCAAAAATAACCTGAAGGGCCC	LONP2_p.K363E
TTTGTCATCACAGCACACACGCTC	GAGCaCACACCTCTTGATA	CAGAAGAGCACACACCTCTTGATAAGGAAG	CENPA_p.T58A
TTTGCTGCATACACACATACTATA	GAAaTATTTGCCATTGCTA	CAGAAGAAATATTTGCCATTGCTAAGGAAT	POLK_p.I484V
TTTGACATCAGTCTCATACATACA	GAAaTATTTGCCATTGCTA	CAGAAGAAATATTTGCCATTGCTAAGGAAT	POLK_p.I484V
TTTGTACGTCACATCTCATCACGC	TGAATaCTGGGAAAGAATG	CACTTTGAATACTGGGAAAGAATGTGGGGA	USP29_p.T397A
TTTGCTCTACACTGTCACATCATC	ATTCaGGTAAACTCTTGAG	CACTTATTCAGGTAAACTCTTGAGTGGAAA	ATAD2_p.Q1377R
TTTGATGCTCACTCTACTACACTC	ATTaGTGGGATACAGTCTG	CACTTATTAGTGGGATACAGTCTGTGGAGC	TDRD6_p.S839G
TTTGGCTACACTCAGCTCACTAGA	GCCCaGGAGATCCTGCCCC	CACTGGCCCAGGAGATCCTGCCCCAGGTGT	ECHDC2_p.Q198R
TTTGTGCACTATCGCTCACTACAT	GCCCaGGAGATCCTGCCCC	CACTGGCCCAGGAGATCCTGCCCCAGGTGT	ECHDC2_p.Q198R
TTTGGCTCTATCTGCTCTACACAG	GTCACaCACAGACTTCCTC	CACTCGTCACACACAGACTTCCTCTGGTGG	FLG_p.T2955A
TTTGCGTCTATCATCATACGTCAT	TGAGCaCCCATGAGTGTGC	CACGCTGAGCACCCATGAGTGTGCCGGCCT	PCBD1_p.T79A
TTTGTACTGTCTATATCTACACTG	TCTGGaGGCGCGCAGTGCC	CACGCTCTGGAGGCGCGCAGTGCCCGGACA	TACR2_p.R226G
TTTGGTACATCATAGCTCACACAT	CGTGGaGGCGGTAAGGCCG	CACGCCGTGGAGGCGGTAAGGCCGCGGGCT	FAM160B1_p.E14G
TTTGAGATCTATCACACTGCTATG	TGTaGGAAGCAACTGCTGC	CACGATGTAGGAAGCAACTGCTGCTGGCTG	EPG5_p.R301G
TTTGTGTACTACTATCACATATAG	GGACGaCGCTGAGGGGGAG	CACGAGGACGACGCTGAGGGGGAGGGGGAG	TCF25_p.D668G
TTTGCGTCATATCAGCTACACGCT	ATGaCGGTCAGTGACCTGT	CACGAATGACGGTCAGTGACCTGTAGGTTT	POLR3B_p.T939A
TTTGTGCATATCATCATGCTATAC	GCCaGTCTGGAGCAGCCCC	CACCTGCCAGTCTGGAGCAGCCCCCGGAGC	OBSL1_p.Q1246R
TTTGGTAGTCTCTCGCTCTACGCT	ACGaCCAGAAGGTGCAAGG	CACCTACGACCAGAAGGTGCAAGGGGGCAA	TPPP_p.D212G
TTTGATCATACTACATCACACGAT	ACGaCCAGAAGGTGCAAGG	CACCTACGACCAGAAGGTGCAAGGGGGCAA	TPPP_p.D212G
TTTGCTGATCTCACTACGTCACAT	ACATCaACGGCCTGACGCT	CACCTACATCAACGGCCTGACGCTGGGCTG	MPV17L2_p.N172D
TTTGTACATACTCGATCTACATAT	ACATCaACGGCCTGACGCT	CACCTACATCAACGGCCTGACGCTGGGCTG	MPV17L2_p.N172D
TTTGCATCATCATCTGCATATCAG	GTCaATGGCCAGCCCCCGC	CACCGGTCAATGGCCAGCCCCCGCTGGGCA	EEF1D_p.N217D
TTTGTCACACATGCTACACACATA	GCTCTaAGTCAGCCAAAAG	CACCCGCTCTAAGTCAGCCAAAAGTGGGTG	IPO9_p.K900E
TTTGTCTATCTATATATACTACAC	CCGCaTCGCAGGGCTCAGA	CACCCCCGCATCGCAGGGCTCAGAAGGTCA	IL16_p.H500R
TTTGTGTCATCTATCTATCAGCGT	TAAGCaCAAGGGTCAGCAT	CACCATAAGCACAAGGGTCAGCATAGGCAG	SEPP1_p.H249R
TTTGCTACTATCATCATATCATAG	GAGTGaAGGTGAGAGGCGC	CACAGGAGTGAAGGTGAGAGGCGCCGGGCA	ACOXL_p.K53E
TTTGTCATACTACTCTACTCACGA	GAACaTATAGAGGCCCTAT	CACAGGAACATATAGAGGCCCTATTGGACA	BRAF_p.H60R
TTTGACACTCACTCTATGCACATA	GAACaTATAGAGGCCCTAT	CACAGGAACATATAGAGGCCCTATTGGACA	BRAF_p.H60R
TTTGTGCTGCTATCACATCTATCT	CCCaAGCAACATCCCTGCT	CACAGCCCAAGCAACATCCCTGCTTGGATG	SLC6A12_p.K583E
TTTGCTCATCACTCTCATCTACGA	CAGaTGAGATCCACGTAAC	CACAGCAGATGAGATCCACGTAACTGGTGA	PRKCG_p.D171G
TTTGCAGCACACTCGATACTCTCT	CAGaTGAGATCCACGTAAC	CACAGCAGATGAGATCCACGTAACTGGTGA	PRKCG_p.D171G
TTTGATACAGCACTCTCATCTCAC	AAGTaCAAGCGCCAGGCAC	CACAGAAGTACAAGCGCCAGGCACAGGCTG	HLA-C_p.Y128C
TTTGTGCACACATACATATCGTAC	TATGGaCAAGGACAGCCGT	CACACTATGGACAAGGACAGCCGTGGGGCG	WNK1_p.D62G
TTTGTGACTCTCATATCACTGTCG	GGTCGaCTGCTTCGTGAGC	CACACGGTCGACTGCTTCGTGAGCCGGCCC	GJD3_p.D178G
TTTGGTATCATCTATCTACTGTCA	GCAGaAGGCACACAGGGAC	CACACGCAGAAGGCACACAGGGACAGGACG	PARVG_p.K319E
TTTGTCGTCACATATAGTCTATAT	ACCCCaTGAGCATGTGGAA	CACACACCCCATGAGCATGTGGAAAGGAAA	RASGRF2_p.H404R
TTTGACTGTCATCTATCATCAGCG	TGCCTaTGTCGCGGCGTGG	CACAATGCCTATGTCGCGGCGTGGCGGTTT	FAM171A1_p.Y241C
TTTGACAGATCACATACATCGCGT	TACaTCAGAAAACTCATAT	CAATATACATCAGAAAACTCATATGGGAGG	ZNF615_p.H278R
TTTGAGACATCATCACTACTACGT	CTGTGaACAAAATTGATCA	CAATACTGTGAACAAAATTGATCAGGGTGC	GBP5_p.N132D
TTTGCTCATCACTACTACATCGCG	TCTaTGGAGTGTGCGGCGA	CAAGTTCTATGGAGTGTGCGGCGATGGGGA	NTRK3_p.Y604C
TTTGAGTAGTCACACTATCATCTG	GCTGCaGGTAGCGGCCGCG	CAAGTGCTGCAGGTAGCGGCCGCGCGGGCC	SLC26A4_p.S55G
TTTGAGTCACACATCTCTGCTATG	GCTGCaGGTAGCGGCCGCG	CAAGTGCTGCAGGTAGCGGCCGCGCGGGCC	SLC26A4_p.S55G
TTTGTCATACTCATCTACAGATCG	CTGGCaTAGAAGCCCGGGC	CAAGGCTGGCATAGAAGCCCGGGCGGGCCC	STXBP2_p.I526V
TTTGTATACATCATGCACTACTAC	CTGGCaTAGAAGCCCGGGC	CAAGGCTGGCATAGAAGCCCGGGCGGGCCC	STXBP2_p.I526V
TTTGCTACACATCACTCAGCTCAC	AGCTGaTCAATAAGTGAGT	CAAGGAGCTGATCAATAAGTGAGTAGGCAT	TRIM54_p.I313V
TTTGACTCTCACTCGATCTACACT	CTTCAaTCGGGCTGGCACG	CAAGCCTTCAATCGGGCTGGCACGGGGCCC	DSCAML1_p.N1130S
TTTGTCTACTCATATCTACAGCTA	AGGaCCCGCAGGGAACTAC	CAAGCAGGACCCGCAGGGAACTACTGGGTA	GARNL3_p.T909A
TTTGTACACATCACACTAGTATCG	GCGaCCGCATTGTCACTTG	CAAGAGCGACCGCATTGTCACTTGTGGGGC	ARPC1A_p.D18G
TTTGATCATCATCATCTCAGCGTA	GGaTTGGAGTCCCCACCAA	CAACTGGATTGGAGTCCCCACCAAAGGTAA	PFKFB2_p.I65V
TTTGCAGTCTACTGCACATCAGTC	CTGaTGAATTAGATTGTAA	CAACTCTGATGAATTAGATTGTAAAGGTAA	LRP1B_p.D2582G
TTTGCACAGTACATCAGCTACATC	GCCACaTGAACGTGCATCG	CAACCGCCACATGAACGTGCATCGTGGTGT	ZBTB12_p.M378V
TTTGTGCATATCTCTACACGCTAC	TCGaGGTGAGGCCGGGCCG	CAACATCGAGGTGAGGCCGGGCCGAGGGCG	DHRS11_p.E49G
TTTGGCTGCACACGTCACTACTAT	AGAaGTGGTACATGTTCGA	CAACAAGAAGTGGTACATGTTCGATGGGCC	DNAH1_p.K1943R
TTTGTACACTACATCTACTCTATA	AATaCTCATATACCAGGTA	CAACAAATACTCATATACCAGGTAAGGCGT	KCTD10_p.Y172C
TTTGATCTCTCACGTCTACACGTA	TCCaTGGAGTCTTTTCTGA	CAAAGTCCATGGAGTCTTTTCTGAAGGTGA	RASA4_p.M352V
TTTGTGACTCACACTAGCTCTATA	TCAaTGAGATGATTATTGG	CAAAGTCAATGAGATGATTATTGGTGGTGG	PGK2_p.N232S
TTTGCTGACACTACTATATCTCAT	CCCaTGGGGGCTCAGACCA	CAAAGCCCATGGGGGCTCAGACCAAGGAAA	WDFY4_p.M2600V
TTTGCACATATACTGCTCTCATCA	AGTTGaAGTTTGCAAGTCA	CAAAGAGTTGAAGTTTGCAAGTCAAGGTCA	DGKB_p.K704E
TTTGAGAGTCACTACACTACATCA	AAAGaGGTCAAGCAGTCTC	CAAAGAAAGAGGTCAAGCAGTCTCAGGTAC	B3GALTL_p.E35G
TTTGTCTCACATAGCACACGATAC	GAACTTAATCCCGTGGCAA	CAAACGAACTTAATCCCGTGGCAAAGGGGT	NT_nontargetX
TTTGATGTACACTCGTATCATCTC	CTTaGTCAAAGAGAAAAGA	CAAAACTTAGTCAAAGAGAAAAGAAGGAAA	ANKRD31_p.S1130G
TTTGATCTAGTCTATCACTCACAT	TGaCCTGTACAGAAGAAGA	ATTTTTGACCTGTACAGAAGAAGATGGGGT	PHYHIPL_p.T286A
TTTGTAGACTCACAGCACGCTACG	AGTaGTGAGGAATGCTACG	ATTTCAGTAGTGAGGAATGCTACGAGGATG	CACNA1D_p.S1868G
TTTGTGCACGCATATCATCTCTCA	GTGCTaTGGCCAATGGGGA	ATTGTGTGCTATGGCCAATGGGGAAGGTCG	WDR6_p.M410V
TTTGGTCTGCACTCTACACTGCGC	ACTGaTGGGGATGAGATGC	ATTGGACTGATGGGGATGAGATGCAGGTTG	PAN2_p.D826G
TTTGGTACACATGCTCACACATAT	GGAGaCAGAGAAACGCCAC	ATTGAGGAGACAGAGAAACGCCACAGGCGG	SPTBN1_p.T1568A
TTTGCATCATATCACAGTCACTAC	GCAaTGACCGCATCAGGGT	ATTGAGCAATGACCGCATCAGGGTGGGGGA	AGT_p.N416S
TTTGCATCTCATCTACACGCTACT	CTACaGTGATGGTGAGCCT	ATTGACTACAGTGATGGTGAGCCTCGGGGT	XYLB_p.S214G
TTTGCTCTGCACACGTCTATATCA	GATCaACCCACAAACAGGT	ATTCTGATCAACCCACAAACAGGTTGGTAT	R3HDM1_p.N488D
TTTGCGACACTCATACTACAGTCG	CATATaGAAGAAGCAGCCA	ATTCCCATATAGAAGAAGCAGCCATGGATG	LRP1B_p.I4052M
TTTGCAGCATCTACATCACTCTAG	CATATaGAAGAAGCAGCCA	ATTCCCATATAGAAGAAGCAGCCATGGATG	LRP1B_p.I4052M
TTTGCAGCTATCACTGCACTAGTC	ACTTTaCCAAGGTATAGTA	ATTCCACTTTACCAAGGTATAGTATGGACT	AMPD1_p.T657A
TTTGCACTACTCATCACACATAGC	CAAaGTGAGGCATTATCAC	ATTCACAAAGTGAGGCATTATCACTGGAAA	C7ORF70_p.S58G
TTTGCGACTCTCATCGTCGTATAG	GATCaGACTGGTGCCTTAG	ATTATGATCAGACTGGTGCCTTAGTGGTTG	PUM2_p.Q443R
TTTGATATCACTCTCACACTCTGT	ACTTCaTGATAACCCCTGA	ATTAAACTTCATGATAACCCCTGAGGGAAT	DNAH7_p.M3104V
TTTGAGCACGTCACTACTCTACTC	GCTaCAGATACTGAGAGGC	ATGTTGCTACAGATACTGAGAGGCTGGAGT	LRBA_p.T1251A
TTTGCATGTCACACACTCACAGAT	CAAGaTAGACCTAATGATG	ATGTTCAAGATAGACCTAATGATGTGGAAT	RB1CC1_p.D316G
TTTGGCATCACTACTACACATGCA	CAGCaCCGGCTCCGGGAGC	ATGTGCAGCACCGGCTCCGGGAGCTGGGGT	NDOR1_p.H526R
TTTGAGACATCACACATACGTCTA	CATTCaCTGTACCGTTTCA	ATGTCCATTCACTGTACCGTTTCATGGCTT	ABCA13_p.H1090R
TTTGTCTCTGCTCATGTCTATCAC	ATCaTGCTCAATGGCACCA	ATGTCATCATGCTCAATGGCACCAAGGAGG	RTFDC1_p.M171V
TTTGCACACACAGACACATCTACT	TAGCCGCCGCTCATTACTT	ATGTATAGCCGCCGCTCATTACTTAGGGTT	NT_nontargetX
TTTGAGTCACGTCACATCACTATC	GAGaCCCCAGAGGCAGAAT	ATGTAGAGACCCCAGAGGCAGAATGGGAGG	RP1L1_p.T1892A
TTTGGCACGCACTATCATCACACA	ATAGaGAAAAAGAAACACA	ATGTAATAGAGAAAAAGAAACACATGGCCA	FSCB_p.E12G
TTTGGTACACTCGATACTCACGTA	ATAGaGAAAAAGAAACACA	ATGTAATAGAGAAAAAGAAACACATGGCCA	FSCB_p.E12G
TTTGCTATACATCACATCATACAG	GGGAaCCACACAGAGAATG	ATGGTGGGAACCACACAGAGAATGTGGGAG	LRRFIP1_p.N394S
TTTGATATGCACACATACATCTGA	GCCTCaGGTAGGATTGGAG	ATGGTGCCTCAGGTAGGATTGGAGTGGGAG	ATP1A4_p.Q175R
TTTGTCTCACATACATATCGTCTG	GAAGTaCGACGCGACTGTG	ATGGTGAAGTACGACGCGACTGTGCGGAAC	POLR2A_p.Y875C
TTTGCATACACACACTCTCACTAC	ACaTGCTGCCCGGGGCAAG	ATGGTACATGCTGCCCGGGGCAAGTGGGGA	KDM3B_p.H1112R
TTTGGACATCTCACTCACGATCAT	ACaTGCTGCCCGGGGCAAG	ATGGTACATGCTGCCCGGGGCAAGTGGGGA	KDM3B_p.H1112R
TTTGGATACTCTCTCACATGCTCG	TTCTaTGAGGGGGAGCTTG	ATGGCTTCTATGAGGGGGAGCTTGAGGATG	RIMBP3_p.Y877C
TTTGCGATCACTGCACACTCTCTA	CGGCaCCCTGGTGACACAG	ATGGACGGCACCCTGGTGACACAGGGGACA	RP1L1_p.T1222A
TTTGCTACTACGACACTCGCTCAC	ACTCaTTATTGCACATGGA	ATGGAACTCATTATTGCACATGGACGGTAA	UBR5_p.I2449V
TTTGCTACAGCACAGTACATATCT	ACTaGGTTCAGTAAGAAGA	ATGGAACTAGGTTCAGTAAGAAGAAGGACA	CYP3A5_p.001
TTTGCTCATACTCACATGTCTATA	GGGCTaCATGAAATCCAAG	ATGCTGGGCTACATGAAATCCAAGAGGCGG	KCNE4_p.Y57C
TTTGTGTCAGTACATCTCGTCATA	GCGCaTGAAACCTCTAAGT	ATGCTGCGCATGAAACCTCTAAGTTGGAAA	MTUS1_p.H1044R
TTTGCTGCACACACTCATATACAC	GCGCaGGTGCACATGGGCG	ATGCTGCGCAGGTGCACATGGGCGGGGCCA	PLXNB2_p.R1435G
TTTGCAGATCACTCTACTCATCAT	GCGCaGGTGCACATGGGCG	ATGCTGCGCAGGTGCACATGGGCGGGGCCA	PLXNB2_p.R1435G
TTTGATATCACATCTCTGTATCAT	GCCaTGGTGAGGACTGGGG	ATGCTGCCATGGTGAGGACTGGGGAGGGGA	TSC1_p.M736V
TTTGCACATGCTATCATCACTCAG	GCCaTGGTGAGGACTGGGG	ATGCTGCCATGGTGAGGACTGGGGAGGGGA	TSC1_p.M736V
TTTGCAGACACACATCTCATCTCA	GATCaCCGTGTACTGCGTG	ATGCTGATCACCGTGTACTGCGTGCGGAGG	DDI1_p.T4A
TTTGACACACTCATCACGTATCAC	CCAGGaGGAAAACAAGGCC	ATGCCCCAGGAGGAAAACAAGGCCGGGTTG	TCIRG1_p.E672G
TTTGTAGCACTACACTGTCATCGC	GAGCaCATGGTTGCCGCCC	ATGCAGAGCACATGGTTGCCGCCCAGGTAA	ARFGEF2_p.H1580R
TTTGCTCGCACATCTCTACTATCG	CGGAGGCTAAGCGTCGCAA	ATGCACGGAGGCTAAGCGTCGCAAAGGGAA	NT_nontargetX
TTTGGTATCACACTCATATCTGTC	AAGaCCAAGACCCTGAGAG	ATGCAAAGACCAAGACCCTGAGAGAGGGAA	GBP4_p.T293A
TTTGGATCACACACACTATCATGC	CAaTGTGGTGAGGACAGCA	ATGAGCAATGTGGTGAGGACAGCATGGGGA	DCST1_p.N455S
TTTGTCATCATCGACATCACTATC	AAGAaTACAGACAACTCAG	ATGAGAAGAATACAGACAACTCAGAGGACA	PBRM1_p.N1080S
TTTGGTATCTACTCACTCGTCACA	AAGAaTACAGACAACTCAG	ATGAGAAGAATACAGACAACTCAGAGGACA	PBRM1_p.N1080S
TTTGGTACATCAGCACACGCACAG	CTGTaCCTAACCCTGGAGA	ATGACCTGTACCTAACCCTGGAGAAGGGGG	DOCK3_p.Y425C
TTTGATAGCATCACTATATCATAC	CAGTaCGAGAAATACCTGC	ATGACCAGTACGAGAAATACCTGCAGGAGG	SEPT9_p.Y275C
TTTGCATATCATCTACACATCTGA	AGCCaTCAATGATGGCTTC	ATGAAAGCCATCAATGATGGCTTCCGGCTC	EPHA2_p.I830V
TTTGCTATCACTCATCACATACAC	AGCCaTCAATGATGGCTTC	ATGAAAGCCATCAATGATGGCTTCCGGCTC	EPHA2_p.I830V
TTTGTAGTACACATACACATCACG	ACTAGCCCGAGCAGCTTCG	ATGAAACTAGCCCGAGCAGCTTCGAGGCAC	NT_nontargetX
TTTGCACTATCAGTACATACTATA	CCTGCaTGGCGATGCCAGC	ATCTACCTGCATGGCGATGCCAGCCGGCCC	TNN_p.H1089R
TTTGTATGTCTACATCTCGTCATA	CCGGGaCCTGGGTGAGGCT	ATCGTCCGGGACCTGGGTGAGGCTGGGTCC	SDF4_p.D244G
TTTGCTCTCTCTCACATATCGATC	CCCCGaGGTGAGAGCTGCT	ATCGCCCCCGAGGTGAGAGCTGCTGGGCAC	PRKCB_p.E511G
TTTGTGTCACATATCAGATCACAG	GTGTaCCGAGTGCGGCCAG	ATCGAGTGTACCGAGTGCGGCCAGCGGCAC	VCPIP1_p.T71A
TTTGACAGCTACATCATGCTCTGC	CTTCaGCGACGGCAAGGCC	ATCGACTTCAGCGACGGCAAGGCCCGGCAC	VSTM2L_p.S148G
TTTGCTCATCATATATATCACATG	GGGCaTGCTGAGGGTGCTG	ATCCTGGGCATGCTGAGGGTGCTGCGGCTG	CACNA1G_p.M1353V
TTTGCGCATATACACTCTCGCTCG	GAACaAGAAGCTGCTCTCC	ATCCTGAACAAGAAGCTGCTCTCCAGGCAC	C2CD2_p.K675E
TTTGTCTGCACATCGCACAGTCTC	CCCCGaCCTCCCGCTGTTC	ATCCACCCCGACCTCCCGCTGTTCCGGGTG	FAM124A_p.D111G
TTTGATCATGCTATCTATCACTCA	CCCCGaCCTCCCGCTGTTC	ATCCACCCCGACCTCCCGCTGTTCCGGGTG	FAM124A_p.D111G
TTTGACTCATGCTACACATGCATC	CTTCTaTGTGAAAGAGGTA	ATCATCTTCTATGTGAAAGAGGTAAGGAGC	TMC7_p.Y577C
TTTGCATCAGACACACTATATCGA	CAAGGaCTTCACCGAGGAC	ATCAGCAAGGACTTCACCGAGGACCGGATT	MVD_p.D59G
TTTGTCAGCACTACATATACTCGA	GGAGTAACAAGCGGACGGA	ATCACGGAGTAACAAGCGGACGGAAGGCAT	NT_nontargetX
TTTGTGTCTACACGATACTACACG	CAAGaTGCTGGGCGCCGAG	ATCACCAAGATGCTGGGCGCCGAGTGGAGC	HMG20B_p.M103V
TTTGCTGCACAGTACATCATCTGA	CCGGaGGAATTTCCGTGCC	ATCAACCGGAGGAATTTCCGTGCCTGGCCC	COL1A1_p.G173G
TTTGTCACAGCACACTCATCTACG	ATTTCaTTCTGTAAGTACC	ATCAAATTTCATTCTGTAAGTACCAGGCTG	LHCGR_p.I152V
TTTGTATCTCGTCACTACTATCGC	GATCaGAAACTTTCGAAGT	ATATGGATCAGAAACTTTCGAAGTTGGTAG	KIAA1530_p.Q3R
TTTGACAGTACATCACACATACGC	GCTAGTACGCTCCTCTATA	ATATCGCTAGTACGCTCCTCTATAAGGGTC	NT_nontargetX
TTTGGCACTCACAGTCTCACGCAC	CCTGGATACCGCGTGGTTA	ATAGTCCTGGATACCGCGTGGTTAAGGGCC	NT_nontargetX
TTTGTATATCATGTCATATCACTC	TAGACGTCGTGAGCTTCAC	ATAGGTAGACGTCGTGAGCTTCACAGGTGT	NT_nontargetX
TTTGTACATCTGCTCACGATACAC	CACGTaCTTTGACACAGAG	ATAGACACGTACTTTGACACAGAGAGGTAA	BACE2_p.Y129C
TTTGTGTCATCATCACTACGAGAC	GGGaCTGGAAAGCCTGGGG	ATACAGGGACTGGAAAGCCTGGGGAGGTTA	AIM1_p.D114G
TTTGGATCACTATCACATATGTCT	CCCTCCGAATCGTAACGGA	ATACACCCTCCGAATCGTAACGGAAGGCGA	NT_nontargetX
TTTGTCTCTAGCATATATCACACG	CCaTTGCTGAAGGAAATAC	ATACACCATTGCTGAAGGAAATACAGGGGA	FAT4_p.I1035V
TTTGACTCACACTCACTCGCTCAT	GCTaAGGCAAACACGAAGA	AGTTTGCTAAGGCAAACACGAAGATGGCCA	RBPMS_p.K100E
TTTGATGCTCTACGTCTATCATAT	CCCaTCAGAGTCAAAGGCA	AGTTGCCCATCAGAGTCAAAGGCAAGGAGG	ANK2_p.I1789V
TTTGTCACTCACTCATACGATACA	AATaTTTAGCTGCAGTGAC	AGTTGAATATTTAGCTGCAGTGACAGGTAG	MDN1_p.Y341C
TTTGCTATGACACTATCACTACTG	TGCaGTCAGGGTGTCCGTG	AGTTCTGCAGTCAGGGTGTCCGTGAGGGCC	C11ORF2_p.S486G
TTTGACATGATCTACACATCACAT	CAGGaACCATTTGTAGCAG	AGTTCCAGGAACCATTTGTAGCAGTGGTGG	COPS5_p.E163G
TTTGTCGTCATCTAGCTCACAGCT	TCTaCCTAAATAAAGATAC	AGTGTTCTACCTAAATAAAGATACAGGAGA	DSG2_p.Y212C
TTTGATCATCTCTCTACATATCAC	TCTaCCTAAATAAAGATAC	AGTGTTCTACCTAAATAAAGATACAGGAGA	DSG2_p.Y212C
TTTGGAGACACACACACTCTAGCT	CCTCaTCAAAGGTCTGCGG	AGTGGCCTCATCAAAGGTCTGCGGAGGGAC	SLC12A5_p.I354V
TTTGGCTACACACTCATACATCAT	CATGCaGACACGCTGTGTC	AGTGGCATGCAGACACGCTGTGTCTGGTCT	RIF1_p.Q2166R
TTTGGTCTCTCTCACTACTACACG	CAAGaGGAGGTGGCGGCGG	AGTGGCAAGAGGAGGTGGCGGCGGTGGTAG	RBKS_p.E13G
TTTGCACATATATATACTCATCGT	ACaTGGTAGCTGGGGAAAG	AGTGGACATGGTAGCTGGGGAAAGAGGAAC	RNF10_p.H162R
TTTGATCTACTCAGCACACTATCA	AAGaCGCCGTGGAACAGCA	AGTGAAAGACGCCGTGGAACAGCAAGGGGA	LYAR_p.D176G
TTTGGTACATCAGTCTCATCGCTC	AAGaCGCCGTGGAACAGCA	AGTGAAAGACGCCGTGGAACAGCAAGGGGA	LYAR_p.D176G
TTTGGATCTACGATCTACACATCA	GACTaTGAGGAAATTAAAA	AGTCTGACTATGAGGAAATTAAAACGGAGC	CUX2_p.Y362C
TTTGGACACATCATAGCTACGTCA	ATaGGGAAGTTAAAGATGT	AGTCTATAGGGAAGTTAAAGATGTTGGTAT	LRRC7_p.I226M
TTTGGCTCACATCTACTACTATCG	GAGCaCATCTCGCTGGCCC	AGTCGGAGCACATCTCGCTGGCCCAGGTGT	ABCA2_p.H2325R
TTTGGTCTCATCACACTACATACT	CTCaCGCCCACCCACGTCA	AGTCGCTCACGCCCACCCACGTCACGGCTG	MAP3K10_p.T811A
TTTGAGTACACACTACTGCACACA	TCAGaCCCCGCCTCGCCGG	AGTCCTCAGACCCCGCCTCGCCGGCGGCCT	CCDC88C_p.D1441G
TTTGCACATATGTCACATCACGTA	CGCAaCCACGTCCACGTGT	AGTCCCGCAACCACGTCCACGTGTCGGTCA	DHH_p.N180S
TTTGTAGACACTCTACGTCATAGC	GGCCaCCAGTGCCAGCCGT	AGTCAGGCCACCAGTGCCAGCCGTGGGCCC	ROR2_p.H335R
TTTGTCTGCGACTCTCTACACTCG	GATCaAGAACAGGAGGAAG	AGTCAGATCAAGAACAGGAGGAAGAGGTAA	ANK2_p.Q1454R
TTTGGCATCACGCTCACTCATCTC	AATGaGCTGAAGCTGGCCC	AGTACAATGAGCTGAAGCTGGCCCTGGAGA	CIT_p.E1260G
TTTGATGTATCTACTCATATCATC	TGCaTaTCATCTGAGACAG	AGGTTTGCATATCATCTGAGACAGTGGCAA	USP34_p.A1183A
TTTGACGTCACATCTCTGCATCTA	TGAaCCACCGTGCCCAGCC	AGGTGTGAACCACCGTGCCCAGCCAGGCCT	ZNF195_p.N109S
TTTGGATCTCACATCGATCAGTAC	CGAGaGCCCGGCCAGGACC	AGGTGCGAGAGCCCGGCCAGGACCTGGTGG	C3_p.E509G
TTTGGTATCATATATCTCACATAC	CGAGaGCCCGGCCAGGACC	AGGTGCGAGAGCCCGGCCAGGACCTGGTGG	C3_p.E509G
TTTGCGCTCATATCACACATGTAC	CAGaGCCGGGTGCCCACCC	AGGTGCAGAGCCGGGTGCCCACCCTGGAGC	SPTBN2_p.S825G
TTTGCGCTCACGTATATCATCATA	ACTCaGTTGGCAAATGACC	AGGTGACTCAGTTGGCAAATGACCTGGCAG	MYH15_p.Q1280R
TTTGACTGTCTACACATCATAGTA	ACTCaGTTGGCAAATGACC	AGGTGACTCAGTTGGCAAATGACCTGGCAG	MYH15_p.Q1280R
TTTGCGAGATCTACATACTCGTCA	CAGGaGGCCAAGGAGCTGA	AGGTCCAGGAGGCCAAGGAGCTGAGGGAGC	MYOM3_p.E141G
TTTGATGCATCATATCATCTACAG	CAGGaGGCCAAGGAGCTGA	AGGTCCAGGAGGCCAAGGAGCTGAGGGAGC	MYOM3_p.E141G
TTTGCACGTCTATCACTGCTATCT	CCaGaGGGAATACCTAGAA	AGGTACCAGAGGGAATACCTAGAATGGACG	ATP12A_p.Q925R
TTTGCGATCTACAGCACATCTGCT	CCaGaGGGAATACCTAGAA	AGGTACCAGAGGGAATACCTAGAATGGACG	ATP12A_p.Q925R
TTTGCTCACACATACATCGTCAGT	AAGaCTTTGGAAGTTGGAA	AGGTAAAGACTTTGGAAGTTGGAAAGGTTG	FRAS1_p.001
TTTGTGTCTACATACACGTCGTAT	CTaCCTGCTGTACCACACC	AGGGTCTACCTGCTGTACCACACCTGGAGC	DOLPP1_p.Y156C
TTTGATAGCTCTCATACTCGCTCA	CAGCaGCGGCCCAGCAGCG	AGGGGCAGCAGCGGCCCAGCAGCGTGGGGC	DGKZ_p.Q21R
TTTGACACACGTCACTCACATCGT	TCCCaCTGTGGACCCACCC	AGGGCTCCCACTGTGGACCCACCCAGGACT	INO80D_p.T169A
TTTGTCTGTCTACTACACTACAGC	GCCaGGCCCCCAGGGAGCG	AGGGCGCCAGGCCCCCAGGGAGCGTGGAGG	DACT2_p.R197G
TTTGGTACACTCACACACTCTCAT	CTTGTaTGGGGCCTTTGGA	AGGGCCTTGTATGGGGCCTTTGGACGGTGC	ABCC10_p.Y235C
TTTGTCTACTATCATCACGATCAC	CCTaTGAATGTAAGGAGTG	AGGGCCCTATGAATGTAAGGAGTGTGGCAA	ZNF621_p.Y207C
TTTGCTAGCACTCTCACTACTCAT	CAGGaGGCCACCTGCAGCC	AGGGCCAGGAGGCCACCTGCAGCCTGGTGC	FSTL3_p.E45G
TTTGCTATATACTACACACTGCTC	ATTGaTGCCAAATGGTCAC	AGGGCATTGATGCCAAATGGTCACTGGCAC	EDC3_p.D454G
TTTGTATCGCACATATCATATATA	AAGTaCATGTACTTCACTG	AGGGCAAGTACATGTACTTCACTGTGGTGA	PHLDA1_p.Y249C
TTTGACACGTCTATCACTCGTCTA	AAAGGaCAGGGCTCTCGGA	AGGGAAAAGGACAGGGCTCTCGGAAGGAGT	FAM71A_p.D430G
TTTGCAGCATATACATACGTCTAT	AAAGGaCAGGGCTCTCGGA	AGGGAAAAGGACAGGGCTCTCGGAAGGAGT	FAM71A_p.D430G
TTTGATCATCTCACAGCATATACT	TGAATaCTGCCTCAAGGAC	AGGCTTGAATACTGCCTCAAGGACAGGATG	IFNB1_p.Y51C
TTTGTGTATCTACGTATCATCTAT	GTaCCAAGGTCCCTGAGCC	AGGCTGTACCAAGGTCCCTGAGCCAGGTTG	SPRR3_p.T91A
TTTGGCGCTACATCACTCTCTAGC	GGTGGaAGCCTGTCGCAAG	AGGCTGGTGGAAGCCTGTCGCAAGAGGCAC	C1ORF65_p.E403G
TTTGGACATCACAGATCACTATCT	CCGaGTGAGTGTGGCCGGG	AGGCTCCGAGTGAGTGTGGCCGGGTGGGCG	CELSR2_p.E2915G
TTTGCTCTAGCTACATACACTACT	CCCaAGCGCATTCACTCCA	AGGCTCCCAAGCGCATTCACTCCATGGCCA	HS3ST4_p.K272E
TTTGGATACATCTCATACTATCTA	TTCaGCCTGAAGGACCGCC	AGGCGTTCAGCCTGAAGGACCGCCTGGCTC	ZNF707_p.S242G
TTTGCTGTCTCATCTACTATCTAC	TGCaCCAAGCGGCTGTGGC	AGGCGTGCACCAAGCGGCTGTGGCAGGCGG	CACNG6_p.T88A
TTTGCATATGACATCTACTACACT	GTGaCCATGTGGCAGCCCA	AGGCGGTGACCATGTGGCAGCCCAAGGACA	CCDC105_p.T45A
TTTGGACAGCATCACATCACAGCA	CCCCaCCTAGAGAAACAGC	AGGCGCCCCACCTAGAGAAACAGCCGGCAG	AKIP1_p.H58R
TTTGATGTCACTACACACATCTCT	AATTCaTAAGTCCATTGAG	AGGCGAATTCATAAGTCCATTGAGAGGTAA	MTMR9_p.H265R
TTTGGAGTATCACTCTACACAGTA	GAGAaGCGGGCAGCCGAGA	AGGCCGAGAAGCGGGCAGCCGAGAAGGTGT	ATP6V1G1_p.K16R
TTTGGAGTATCACACTCACGTCGT	CCAGGaTCTGCCTGAAGAT	AGGCCCCAGGATCTGCCTGAAGATAGGTAT	C19ORF45_p.D242G
TTTGACATGTACACTCATATCAGC	ATaAAGGAGAAAGGCAAAG	AGGCCATAAAGGAGAAAGGCAAAGAGGAAC	MRPL15_p.K54E
TTTGCACAGTCACATACACGTCAC	ACCCaGAAAAGCCTGCCTC	AGGCCACCCAGAAAAGCCTGCCTCAGGGGC	TTF2_p.Q305R
TTTGCGCTCACACGCACTCACATC	AAGGaCCTCGCCAGCAAGG	AGGCCAAGGACCTCGCCAGCAAGGCGGCCA	PRELID1_p.D202G
TTTGTACACTCATCTGTATACTAT	AAGAaGGCGGATTAGGGGG	AGGCCAAGAAGGCGGATTAGGGGGTGGCCC	TMEM38A_p.K297R
TTTGAGTCTCATCTATCACGCTGC	AAGAaGGCGGATTAGGGGG	AGGCCAAGAAGGCGGATTAGGGGGTGGCCC	TMEM38A_p.K297R
TTTGGTCATCTACACTAGCATACG	GTGaCGGTACTGGAGGATC	AGGCAGTGACGGTACTGGAGGATCTGGAGA	ZSCAN16_p.T114A
TTTGAGTCACTATATCAGCACTCA	GTGaCTGTGGACTTCACCC	AGGATGTGACTGTGGACTTCACCCAGGAGG	ZNF382_p.T12A
TTTGATATCTACTATCATCATGCG	GTAAaCCCTGCCAAAAAGG	AGGATGTAAACCCTGCCAAAAAGGAGGTGA	AVIL_p.N777S
TTTGACACTGCGTCATATCACGCG	TGCaGCAGTCGCGGCCGCC	AGGAGTGCAGCAGTCGCGGCCGCCCGGACA	DAB2IP_p.S381G
TTTGACTAGCTACACTCTCACTCA	TATaTGATTATGAAAATAC	AGGAGTATATGATTATGAAAATACAGGAAG	FLG_p.Y215C
TTTGATCTACACTACTACACACAT	TATaCAAAGACATGCATGT	AGGAGTATACAAAGACATGCATGTAGGTAG	SMC1B_p.T442A
TTTGGCTCAGATCACATACTCTAC	TATaCAAAGACATGCATGT	AGGAGTATACAAAGACATGCATGTAGGTAG	SMC1B_p.T442A
TTTGTACTGCATCTCACTATCGTC	GCAGaGCACTTCAAGACAT	AGGAGGCAGAGCACTTCAAGACATGGGAGG	C19ORF29_p.E207G
TTTGAGTCATCTACTACATCATCA	GAGGaGGAGGAGGAGCAGG	AGGAGGAGGAGGAGGAGGAGCAGGCGGATG	CACNA1I_p.E575G
TTTGGATCAGTCACACTGTCACAC	CTGGTaCGTTGCCCCACCT	AGGAGCTGGTACGTTGCCCCACCTGGGGAG	GOLGA6L9_p.001
TTTGCTACTGCTACACTATCGCTC	CTGGTaCGTTGCCCCACCT	AGGAGCTGGTACGTTGCCCCACCTGGGGAG	GOLGA6L9_p.001
TTTGGATCACACATCACTACGAGA	CGGGaCCGCAAATTGAAGG	AGGAGCGGGACCGCAAATTGAAGGAGGAAA	ZNF609_p.D1164G
TTTGACTCTCTACACATGCTCACT	CAGGaTGGTAAAGAGTGGA	AGGAGCAGGATGGTAAAGAGTGGATGGAGG	RASGRF2_p.D120G
TTTGGACTCTATATACTCAGTCAC	AGGGaGGTGTTGGCAGGTT	AGGAGAGGGAGGTGTTGGCAGGTTCGGAGA	C1ORF173_p.E1358G
TTTGCTCATAGTCACACTGCATCT	GAAGaAGAGGAGGACGAGG	AGGACGAAGAAGAGGAGGACGAGGAGGAGG	PPP6R1_p.E673G
TTTGAGTCTCATGTCATCTCTCTC	GAAGaAGAGGAGGACGAGG	AGGACGAAGAAGAGGAGGACGAGGAGGAGG	PPP6R1_p.E673G
TTTGTCACACTCATCGCTACGTCA	CGGaCCAAGATGCCCTACA	AGGACCGGACCAAGATGCCCTACATGGAGG	CYP2A7_p.T296A
TTTGACATCTCAGCACAGCTACTA	TTTGaAGACTATCTTCACC	AGGAATTTGAAGACTATCTTCACCAGGAAA	RGSL1_p.E243G
TTTGTCTCTCATCTGCGCACACAC	TAAAaGTAGACGGTTATAT	AGGAATAAAAGTAGACGGTTATATGGGCAG	POLQ_p.K300K
TTTGTACAGTCTCACTCTCATACG	TAAAaGTAGACGGTTATAT	AGGAATAAAAGTAGACGGTTATATGGGCAG	POLQ_p.K300K
TTTGGTCATCAGTACATACAGCTC	GGGAGaGAGAACAACATGT	AGGAAGGGAGAGAGAACAACATGTGGGTGG	MDC1_p.R674G
TTTGGACTCTCATACACTCGATAC	GGGAGaGAGAACAACATGT	AGGAAGGGAGAGAGAACAACATGTGGGTGG	MDC1_p.R674G
TTTGGTCTATCTATATCACTCACG	GCACaGGTGAAAGTGGCCG	AGGAAGCACAGGTGAAAGTGGCCGAGGTGG	LETM1_p.Q449R
TTTGTCTCAGCATCAGTCTCATAT	ATCaTGGAGGGGAAAAGCC	AGGAAATCATGGAGGGGAAAAGCCAGGTAC	PIKFYVE_p.M142V
TTTGACACTACGCTACACTCTCGC	ATAAaCGATGTGGACGTAC	AGGAAATAAACGATGTGGACGTACAGGAAC	GRID2_p.N266S
TTTGTACTCTGATCACACTCTCAT	AAGTGaCGGTGAAGACTGA	AGGAAAAGTGACGGTGAAGACTGAGGGAGG	MYH2_p.T61A
TTTGAGAGATCACATCTACTACAC	TAAaTGCAAAGGTGGTTGG	AGCTTTAAATGCAAAGGTGGTTGGAGGGCC	KCTD3_p.N235S
TTTGATAGTCACTACATCTCAGCG	CAAGTaGTTCATGCATGGG	AGCTTCAAGTAGTTCATGCATGGGTGGAAA	CD200R1L_p.S19G
TTTGCAGTATCATCACACACATCA	TACCaGGGCCACGTGCGGC	AGCTGTACCAGGGCCACGTGCGGCTGGTCT	SLIT3_p.Q1210R
TTTGCGTCTGCTACACACTGCACA	GTGaTGTATTATTCATTCC	AGCTGGTGATGTATTATTCATTCCTGGTAA	TYW5_p.D225G
TTTGTGTCATCAGCTCACGTCATA	GTGaTGTATTATTCATTCC	AGCTGGTGATGTATTATTCATTCCTGGTAA	TYW5_p.D225G
TTTGCTCATATCTGCACTCACACA	GCCaGTCAAGCTAATAGGA	AGCTGGCCAGTCAAGCTAATAGGAAGGAGG	GIP_p.S103G
TTTGTGTCATATCAGCTCGTATAT	CTGCaGGTACCTGTGTGTG	AGCTGCTGCAGGTACCTGTGTGTGAGGCGC	GOLGA3_p.Q1326R
TTTGCTCATGCTCACTAGCTATCG	TTGGaGGTGTACGAGCAGC	AGCTCTTGGAGGTGTACGAGCAGCTGGGTG	FGD3_p.E353G
TTTGCTCTGTCATCATCATCGACA	TACATaAGATGGGTCCAGG	AGCTCTACATAAGATGGGTCCAGGTGGGGG	KIAA0913_p.K577E
TTTGTCGACTCGTATCATATATCA	TACATaAGATGGGTCCAGG	AGCTCTACATAAGATGGGTCCAGGTGGGGG	KIAA0913_p.K577E
TTTGACTAGTCACACATCACAGTA	CACaTGGAGCTGGCCAGCA	AGCTCCACATGGAGCTGGCCAGCAGGGTGT	POLRMT_p.M406V
TTTGCATCATGCTCACACTCGCTC	CACaTGGAGCTGGCCAGCA	AGCTCCACATGGAGCTGGCCAGCAGGGTGT	POLRMT_p.M406V
TTTGTGTACAGCATCATCTCATCG	CACaAGGGTCAGATGAAGA	AGCTCCACAAGGGTCAGATGAAGATGGTCC	GPAT2_p.K183E
TTTGGTCATCTCATCACATCACAT	CACaAGGGTCAGATGAAGA	AGCTCCACAAGGGTCAGATGAAGATGGTCC	GPAT2_p.K183E
TTTGATGTATACACATATCGATAC	ATTCaGCTCCTCTGGAGGA	AGCTCATTCAGCTCCTCTGGAGGACGGCAG	C8ORF48_p.S39G
TTTGCATGCACGTCTACTCATCTA	AGTGCaTGGGTCGGCCGCG	AGCTCAGTGCATGGGTCGGCCGCGCGGACG	C16ORF93_p.H36R
TTTGAGACATCTCACTCATACTAC	CTGaGGAAGGTCATCCAGG	AGCTACTGAGGAAGGTCATCCAGGTGGAAC	CCL27_p.R48G
TTTGTGCTCTCTCAGCGTCATCAG	CATAGTCGACGGCTCGATT	AGCTACATAGTCGACGGCTCGATTAGGAAT	NT_nontargetX
TTTGTCATATCTACACATCATCGT	TCCaCTGCGCCAGGACCTA	AGCGTTCCACTGCGCCAGGACCTATGGCAA	ZNF278_p.H540R
TTTGGCACATCATGTCACACTACT	GAGaTGGAGGCGCTGGCTG	AGCGTGAGATGGAGGCGCTGGCTGCGGAGA	TEKT4_p.M109V
TTTGTACTCTATCACACAGCGTCG	GCAaCCCTGATGGGCGGCC	AGCGGGCAACCCTGATGGGCGGCCAGGTAT	HSD3B7_p.T250A
TTTGATCTATCACTCTACACTACA	CTGCaGGAGATAGAAGAAT	AGCGCCTGCAGGAGATAGAAGAATTGGAGC	SRPK2_p.Q288R
TTTGTATCTCTATACTCGCACACG	ATaGGTAAGGGAGAGGCCC	AGCGCATAGGTAAGGGAGAGGCCCAGGTGG	AGXT_p.I119M
TTTGTCAGCTCTATCTAGTACTCT	AGCAaCACTTCCGAAACAC	AGCGCAGCAACACTTCCGAAACACCGGAGC	NAV2_p.N2025S
TTTGGACACACTCTCTATACTAGT	GCGCGaCGCGGCCAAGCAC	AGCGAGCGCGACGCGGCCAAGCACAGGCTG	PCDHB3_p.D634G
TTTGGAGTCACATCTACTAGCACA	ACAGaTGATATCCCTGTTT	AGCGAACAGATGATATCCCTGTTTGGGACC	SKP1_p.D83G
TTTGTCTGTACTCATCATCGTATA	GCaGTGTCACCTGTGGAAA	AGCCTGCAGTGTCACCTGTGGAAAAGGCAT	HMCN1_p.S4542G
TTTGCTACATCATCATCACTAGAC	GAGaTGGAGTGGCAGAAGG	AGCCTGAGATGGAGTGGCAGAAGGTGGAGT	C10ORF93_p.M1213V
TTTGAGTCACAGCATCACTCATAG	CGTCaCCAGCGTGGTAAGG	AGCCTCGTCACCAGCGTGGTAAGGCGGGCG	KIAA0415_p.T1355A
TTTGCACTATGCTCTATCACACAT	CCGGaGAAGGACGACCAGC	AGCCTCCGGAGAAGGACGACCAGCTGGTGG	PRAP1_p.E54G
TTTGCTACATCTACACACATACAT	GAGCaGGAGCCGGAGCCCA	AGCCGGAGCAGGAGCCGGAGCCCACGGCCA	ERBB3_p.R1120G
TTTGGCGCACTACTCGCACTCGTC	GAGCaGGAGCCGGAGCCCA	AGCCGGAGCAGGAGCCGGAGCCCACGGCCA	ERBB3_p.R1120G
TTTGCTATAGCTCACTACTATACT	AAGGaCGACGACGATGAAG	AGCCGAAGGACGACGACGATGAAGAGGAGG	CHD5_p.D398G
TTTGAGTCATCGATCTACTACATA	TGGaCGCGGCTTAACGTCC	AGCCCTGGACGCGGCTTAACGTCCGGGACA	TRIM62_p.T405A
TTTGGACTATCTATCTACTCTGCT	TGCCaGCAGCAGCCGGAAG	AGCCCTGCCAGCAGCAGCCGGAAGGGGAGC	PITPNM3_p.S289G
TTTGCATGCATCTCATATCATACA	CACCaGAAGGTGGAGGCCC	AGCCCCACCAGAAGGTGGAGGCCCAGGTGA	TUFM_p.Q353R
TTTGGATATCTACATCTACACTCA	AGGaGCCAGTCTCTGGCTG	AGCCCAGGAGCCAGTCTCTGGCTGTGGCTC	SCARF1_p.E792G
TTTGCTGCATCTCATATACAGCTC	TTCaGGTGCTGACCGCGCA	AGCCATTCAGGTGCTGACCGCGCAGGGACC	AZI1_p.Q341R
TTTGCATACACTGCTACTACTCAG	CACaGGGACACTCATGGTG	AGCCACACAGGGACACTCATGGTGTGGAGG	ZNF17_p.R175G
TTTGATGCTCACTACACGATCACG	TACCaGAAAGTGCCTCTGA	AGCATTACCAGAAAGTGCCTCTGAAGGAGC	TSHZ1_p.Q288R
TTTGTGCACACTACACTGCATCGT	CATTTaCAGAGGATAGATT	AGCATCATTTACAGAGGATAGATTTGGAGT	TMEM48_p.T577A
TTTGATACACTCTCACTCTACAGA	GGCaCCCACCAGCAGCTGC	AGCAGGGCACCCACCAGCAGCTGCTGGCCC	ABCB9_p.T723A
TTTGCAGATCTACATCTACTATAT	GAGaAAAAGATGTGGAGGC	AGCAGGAGAAAAAGATGTGGAGGCAGGAGG	GOLGA6L6_p.K451E
TTTGGATACATGCTCACGTCATAG	CTCCaGCTCGGGCGCCCCT	AGCAGCTCCAGCTCGGGCGCCCCTGGGCCC	MKL1_p.S319G
TTTGCTACACGTCACTCTCTCTAG	CAGCCaAGGGGCCCATGGC	AGCAGCAGCCAAGGGGCCCATGGCTGGCAT	GAPDHS_p.K339E
TTTGCATGCACATACAGCTACTAC	AATGaGGCCACCCTGGCCG	AGCAGAATGAGGCCACCCTGGCCGAGGATA	SCN4A_p.E455G
TTTGATGACACTCACTAGTACTCT	TACCaGCAGCAGCAGCAGG	AGCACTACCAGCAGCAGCAGCAGGTGGCTG	BHLHA15_p.Q154R
TTTGCGTCAGACACTCGCTACTAT	CGCGaCGCCGAGGAGGCGC	AGCACCGCGACGCCGAGGAGGCGCTGGACA	KCNC2_p.D161G
TTTGCGCACATCGCTCTCTCTCGC	CCAaGAAAGCTGCGGTAGA	AGCAACCAAGAAAGCTGCGGTAGATGGAAG	TTN_p.K8446R
TTTGATGATCACTACAGCTATATA	GCCCaTAAATTTAATCAGG	AGATGGCCCATAAATTTAATCAGGAGGTAA	IPO11_p.H815R
TTTGTCACTATCATCACAGATCTA	GAGGaCTATCCCAGCTTCA	AGATGGAGGACTATCCCAGCTTCATGGCAA	AATF_p.D347G
TTTGTACATATATCACTGCGCGTA	AAGCaGTGTGTCCGGCTGA	AGATGAAGCAGTGTGTCCGGCTGACGGTCC	PLXNA4_p.Q557R
TTTGTAGTCACACTGTCATATCGC	TTTCaGAACACCCGTCCCC	AGATCTTTCAGAACACCCGTCCCCGGGTCG	PKD1L2_p.Q1616R
TTTGACACTATCTATACTCTGCAT	CTGGaGCCTCTGAAAAACG	AGATCCTGGAGCCTCTGAAAAACGCGGCGG	OBSCN_p.E4436G
TTTGCGTCACACACACTACATCAC	CTGATaCTGGTAAACTGAC	AGATCCTGATACTGGTAAACTGACTGGCGG	PHIP_p.T1030A
TTTGGATCTATCACATCACTGCTC	CTCaCCCAGGAAGGATGGG	AGATCCTCACCCAGGAAGGATGGGTGGACG	NALCN_p.T552A
TTTGTATCTCTACATCGCTCTGCA	AGCaTGGTTTGGTACAATC	AGATCAGCATGGTTTGGTACAATCTGGTGC	QRICH2_p.H542R
TTTGTGCACACACACTACGTCACA	TTGaCCTGTTACAGAAACA	AGATATTGACCTGTTACAGAAACATGGAAT	DMC1_p.D25G
TTTGGACATCTCTCACTCGATCTA	TGATaAAGATGTTGGTCAA	AGATATGATAAAGATGTTGGTCAATGGAAA	RANBP2_p.K2344E
TTTGATCACTCTCTATCGTCAGTA	AAAaCAGTCCTTTCTACTA	AGATAAAAACAGTCCTTTCTACTATGGTGA	FXYD3_p.N27S
TTTGAGACTCATCGCACACAGCTA	GAAGaCATAAAGATCCGCC	AGAGTGAAGACATAAAGATCCGCCAGGACA	HSF1_p.D129G
TTTGACAGCATATCTCACTCATAC	CGGCGaCGGTGGCGGCCAA	AGAGTCGGCGACGGTGGCGGCCAAGGGGCA	NAA30_p.T63A
TTTGCTGCACGATACATCTACATC	CAACTaTGACCTAAGGAAC	AGAGTCAACTATGACCTAAGGAACTGGAGA	TRHDE_p.Y693C
TTTGTAGCTCGTCTACTCTCACAG	CAACTaTGACCTAAGGAAC	AGAGTCAACTATGACCTAAGGAACTGGAGA	TRHDE_p.Y693C
TTTGGCTCTCTCACTCAGATCAGT	ATCaGGTAATTTCAAAGGT	AGAGTATCAGGTAATTTCAAAGGTAGGAGG	C11ORF85_p.R34G
TTTGTATCTCTCTCGCACACTCAG	GCGCGaGTCGGAGCCCCCG	AGAGGGCGCGAGTCGGAGCCCCCGGGGAGT	SORCS1_p.S125G
TTTGCAGTACACTCATCGACATCA	CTCaGTCCACCGCAGCTGG	AGAGGCTCAGTCCACCGCAGCTGGAGGACA	VSX2_p.S353G
TTTGTATGACTCACTCTCACTGTA	CACCaGAATGTCAGGTGGG	AGAGGCACCAGAATGTCAGGTGGGCGGTGA	ADCY7_p.Q276R
TTTGCGTCACTGCACACGATACAT	ATTCaGGGAGCCAGGGTCC	AGAGGATTCAGGGAGCCAGGGTCCTGGTGT	UBA7_p.Q31R
TTTGTATACTCATCATACACTATC	AGTaCTTGCGGCAGGTGGG	AGAGGAGTACTTGCGGCAGGTGGGCGGCTC	ARC_p.Y227C
TTTGACTACTACACACGCACTCGT	ACGGCCTAACTTGCTGATA	AGAGCACGGCCTAACTTGCTGATAAGGAAA	NT_nontargetX
TTTGCATACAGCATCATATCAGAT	AAGTaCCCACAGCACGCCC	AGAGCAAGTACCCACAGCACGCCCTGGCCC	SRCIN1_p.Y91C
TTTGACAGTCTACACAGCACATCA	TGCaAAGTCTACACCCAGA	AGAGATGCAAAGTCTACACCCAGAAGGGGG	KIF26B_p.K1090E
TTTGCTACATATCTCTCGCTCGAC	CTAaCGGCACGGACAGCAA	AGAGACTAACGGCACGGACAGCAATGGCAG	PPP3CA_p.N508S
TTTGCATATCAGACACACATCGTC	AAATGaCAGTCAGCCTCCC	AGAGAAAATGACAGTCAGCCTCCCAGGACC	ZP2_p.T653A
TTTGATCACATCTACTCTCAGTAG	GTAaGTTCCCAGGAAACAC	AGACTGTAAGTTCCCAGGAAACACAGGCAG	RPTN_p.K112R
TTTGTATCTAGTCTATATCTCGTC	AGCaGTGACCCAGATGTTC	AGACTAGCAGTGACCCAGATGTTCTGGAAT	GAB4_p.S74G
TTTGACTACATCTCACTCTATGCG	AGCaGTGACCCAGATGTTC	AGACTAGCAGTGACCCAGATGTTCTGGAAT	GAB4_p.S74G
TTTGACTACTCACTCTAGTATCAC	GAAaCCCGCTTCAACCAGC	AGACGGAAACCCGCTTCAACCAGCTGGTCG	RBM28_p.T728A
TTTGCACTGCATCACACTACACTA	TCAGCaTGCAAGGTGGGCG	AGACCTCAGCATGCAAGGTGGGCGGGGCGG	MSLN_p.M601V
TTTGCACATCTCACTCGTCACTCG	CTTTaTAAAACACAAGTTA	AGACCCTTTATAAAACACAAGTTAGGGAGC	ROCK2_p.Y876C
TTTGATGCACACACACTCATCATA	ATGGGaAAAATGTGAACGA	AGACCATGGGAAAAATGTGAACGAAGGAGA	MBD5_p.K1174E
TTTGATGCATATACATCTCTACAC	ACTCaGGGGGGACCATGCC	AGACCACTCAGGGGGGACCATGCCCGGCAG	KIAA1683_p.Q818R
TTTGTATCACGCTATCTCGCTCGC	GGAATaCAGGAAGTATGGA	AGACAGGAATACAGGAAGTATGGAGGGGCC	IGF1R_p.Y885C
TTTGATACACATGTCACTATCTAG	GGAATaCAGGAAGTATGGA	AGACAGGAATACAGGAAGTATGGAGGGGCC	IGF1R_p.Y885C
TTTGTATCTATCAGCACTCTGCTA	GGGGaGCTGAGGTCCCCAG	AGAATGGGGAGCTGAGGTCCCCAGAGGCCG	LMTK3_p.E1007G
TTTGTGTACTACATCTACACGTCG	GATaAAAAAACTGTAGAAG	AGAATGATAAAAAAACTGTAGAAGCGGAAA	RAD51AP2_p.K314E
TTTGACATATCACACTCATATAGC	GAGCTaAATGAGTTGCGCA	AGAATGAGCTAAATGAGTTGCGCAAGGCCC	MYO5A_p.L1222L
TTTGAGTCACTATCACACACTACT	GAGCTaAATGAGTTGCGCA	AGAATGAGCTAAATGAGTTGCGCAAGGCCC	MYO5A_p.L1222L
TTTGCTGCTCACGCTCACATCAGC	GAGCaGATGCATGCGCTGC	AGAATGAGCAGATGCATGCGCTGCTGGCCA	EIF3L_p.Q366R
TTTGCTACATCATCTCACACTGCA	CCACaAGGTAAGCGGCCGG	AGAATCCACAAGGTAAGCGGCCGGAGGTCG	UBE2D2_p.K8E
TTTGTCTCATCACTCACATACGTC	GTGaCCCTATGGAGTTTAG	AGAAGGTGACCCTATGGAGTTTAGTGGCAG	WDR20_p.D323G
TTTGATATCTCACACACTCATCGC	GATGaCATGCTGTACATCC	AGAAGGATGACATGCTGTACATCCTGGTTG	ALK_p.D769G
TTTGCTGCACACTCTGCTACGTAT	GATGaCATGCTGTACATCC	AGAAGGATGACATGCTGTACATCCTGGTTG	ALK_p.D769G
TTTGATACATACTACACGATACTA	CTTTaCAAGAGTGGCCTCA	AGAAGCTTTACAAGAGTGGCCTCATGGATG	DNAH2_p.Y1727C
TTTGACAGTCACGCTCACACATCA	AATTaCAAGAGCTCAGGGA	AGAAGAATTACAAGAGCTCAGGGACGGTAG	CPNE6_p.Y276C
TTTGTCTCTATCACATATCAGTAC	AAGaGAGGGAGGAGAGGTC	AGAAGAAGAGAGGGAGGAGAGGTCTGGCCT	SP100_p.E161G
TTTGATCTCAGCACACTCACACGA	TTCaCCATCCTGCAGGTAT	AGAACTTCACCATCCTGCAGGTATGGGGGC	TEAD3_p.T395A
TTTGCTCACACGCACTACTCAGCT	GCCGaGATCGCCTACTCGC	AGAACGCCGAGATCGCCTACTCGCTGGACT	PCDH7_p.E522G
TTTGAGACTCTCATATCTGTCGAT	CCCaCCATCGTGGAGGTGC	AGAACCCCACCATCGTGGAGGTGCTGGAGG	NOS1_p.T1150A
TTTGCGCTCTGCTACACACAGCTC	CACaACAACTGGGAGGCTG	AGAACCACAACAACTGGGAGGCTGCGGTGG	C10ORF46_p.N23D
TTTGTGCATCAGCACACTCATCTC	CACaACAACTGGGAGGCTG	AGAACCACAACAACTGGGAGGCTGCGGTGG	C10ORF46_p.N23D
TTTGCGACTCGTCTACTACTCAGC	TGGaGTCAATGGATGAGGC	AGAAATGGAGTCAATGGATGAGGCAGGTTA	IGFN1_p.E2099G
TTTGGTCACTCATACTATGCTATC	TCTaAAGTTGCTGATGCAG	AGAAATCTAAAGTTGCTGATGCAGAGGAAA	CCDC30_p.K348E
TTTGCGACAGCACTCTACATATCT	GCTCaGGAGGCTCTCCACT	AGAAAGCTCAGGAGGCTCTCCACTTGGCTG	KIF6_p.Q490R
TTTGCTCTCACAGACTCATCATAG	GATGaGATGCTGCAAGAGC	AGAAAGATGAGATGCTGCAAGAGCTGGAGA	PMFBP1_p.E263G
TTTGTGTCACTCGTCACTCTGCGT	GAGaGGGGGAAGAAGCCCA	AGAAAGAGAGGGGGAAGAAGCCCAAGGAGA	VSIG2_p.R270G
TTTGTCTGCACTCATCGTCATACG	GACaCTGCGGTGGAAGGTG	AGAAAGACACTGCGGTGGAAGGTGAGGAGA	CADM1_p.T155A
TTTGAGCATCTCATATCTACACAT	CGAGaTGCCCAGAGCCGGC	AGAAACGAGATGCCCAGAGCCGGCAGGAGC	CROCC_p.D1098G
TTTGCTCGACACTATCACTCACTC	AGTGGaCACAAGAAAATTT	AGAAAAGTGGACACAAGAAAATTTCGGTCT	SORBS2_p.D105G
TTTGTGACATCTCTACAGTCACAC	AGGaGCTCCCCTGGAAGAG	AGAAAAGGAGCTCCCCTGGAAGAGTGGGCA	SLC9A5_p.E761G
TTTGTAGCTACGTCACACACTGCT	AAATGaAATGTAAGATTGC	AGAAAAAATGAAATGTAAGATTGCAGGTTG	EFCAB1_p.K106E
TTTGCTGATCACATCATCACGAGT	AAAaAGCGTCTGGCAAAGA	AGAAAAAAAAGCGTCTGGCAAAGAAGGAGA	STK32A_p.K328E
TTTGTACTGCACATCGTCTACACA	AAAaAGCGTCTGGCAAAGA	AGAAAAAAAAGCGTCTGGCAAAGAAGGAGA	STK32A_p.K328E
TTTGCATGCATCACTCTATCGTAT	TCCGaGTTCTACGTTGAGC	ACTTCTCCGAGTTCTACGTTGAGCTGGAGG	ADCY5_p.E1082G
TTTGTATGTCACTCTACTCGTCAT	CACTaCTCGCTGGCCACGC	ACTTCCACTACTCGCTGGCCACGCAGGTGC	NRG2_p.Y609C
TTTGACATGCTCATACATCTCTCA	GAACaTCCCGATGTGTCCT	ACTTAGAACATCCCGATGTGTCCTTGGCAG	CACNA2D3_p.H644R
TTTGATATCACTGCGTCTACTCGA	GAGATaCCAGGCCCAGACC	ACTGTGAGATACCAGGCCCAGACCTGGAGG	TRIM10_p.I46M
TTTGTCGTCATATCAGCTCAGTAC	GAGATaCCAGGCCCAGACC	ACTGTGAGATACCAGGCCCAGACCTGGAGG	TRIM10_p.I46M
TTTGATCATCTGATACTCACTCAT	GATGaAGTGCTGGAGCTGC	ACTGGGATGAAGTGCTGGAGCTGCGGGAGA	RASAL1_p.E182G
TTTGATATACATCTAGCACTCAGA	GAAGaTGGCCGTCTTTCCT	ACTGGGAAGATGGCCGTCTTTCCTTGGTAA	C16ORF62_p.M1V
TTTGATCGTCACTAGCATCATCAG	AGGGCaGGAGGTGGAATCT	ACTGCAGGGCAGGAGGTGGAATCTGGGCAG	PDCD11_p.Q884R
TTTGCACTATCAGATACTCTCATC	AGGCaGAACGCATATGCAG	ACTGCAGGCAGAACGCATATGCAGTGGCGT	GPR149_p.Q380R
TTTGACGCTCTCACACTCATATAC	AATaCTACCTGTTGCGTGA	ACTGCAATACTACCTGTTGCGTGAAGGAGT	TSPYL1_p.Y407C
TTTGGCTCTCACACACTCTGTCAT	GGAGCaGACGCAGTACTCC	ACTCTGGAGCAGACGCAGTACTCCTGGGAG	ABP1_p.Q556R
TTTGATCTCATAGCTCTACACGAT	CAGaTCCTGAAGGAGCTGG	ACTCTCAGATCCTGAAGGAGCTGGAGGAGT	INSR_p.I719V
TTTGATATGCACATCATCTCGCTA	TCGTCCGGGATTACAAAAT	ACTCGTCGTCCGGGATTACAAAATAGGTGG	NT_nontargetX
TTTGGCTCACTCATCATACACGTC	ATCCaGCTGCGGGAGGAGG	ACTCCATCCAGCTGCGGGAGGAGGCGGAGC	TEKT5_p.Q315R
TTTGTGCACATGTCACACTCATAC	TAATaCCACCAATTAAAGA	ACTCATAATACCACCAATTAAAGAGGGAAA	PCDH15_p.I1190M
TTTGAGACACTACTCACACATGCA	GTTGaCAGACATGATGAAA	ACTATGTTGACAGACATGATGAAAGGGAAT	EMC3_p.T108A
TTTGGCTCTGATACTCACACTACT	AGAaCTGCGGTGTTCCCGA	ACTACAGAACTGCGGTGTTCCCGAAGGCCA	MYPN_p.N1180S
TTTGTCTATCACATCGACTCTCTA	GATGaCCCCTTCTCAGTGG	ACGTGGATGACCCCTTCTCAGTGGAGGAGG	SLC7A14_p.D700G
TTTGATAGCATATCATCACACTAC	CCAaTGGAATGGAGCTTGA	ACGTGCCAATGGAATGGAGCTTGATGGGCG	TRA2B_p.N180S
TTTGGTCTATCACAGCTCTGCTCG	GCCaCGGACCTGTGGCTGG	ACGGTGCCACGGACCTGTGGCTGGCGGCCT	XKR7_p.T73A
TTTGGACACACATATACTACTATG	CACaGCAGCTCCGTGTCCC	ACGGGCACAGCAGCTCCGTGTCCCAGGTAC	GATA4_p.S377G
TTTGTGCACTACACACTGCACTAC	AGCaGCAGCTGCAGCGGGA	ACGGGAGCAGCAGCTGCAGCGGGACGGTGG	CD6_p.S52G
TTTGGTCTCTCACTACAGACTCTC	GAAGaCGCGGGCGGCGGCG	ACGGCGAAGACGCGGGCGGCGGCGCGGGCA	UBFD1_p.D300G
TTTGCATGCACTATCACACTACTG	CCCaATTTCCCGGGACCAA	ACGGCCCCAATTTCCCGGGACCAAGGGGGC	DIDO1_p.N1770D
TTTGTGCTACACAGTCTATCATAC	AATCGGCGACGTTTTAAAT	ACGGCAATCGGCGACGTTTTAAATAGGATA	NT_nontargetX
TTTGACATACATCTCTCTCTCTAT	ACTaCAAATCCAGTACAGA	ACGGAACTACAAATCCAGTACAGATGGGGC	IL1RL1_p.Y387C
TTTGAGACTCTCTATCAGTACATC	ACGaGGTGCAAGGGCGGCA	ACGGAACGAGGTGCAAGGGCGGCAGGGTTA	PCGF1_p.001
TTTGACTACACTCACACAGATCTA	CTACAaGACCGAGCTGTGC	ACGCGCTACAAGACCGAGCTGTGCCGGCCC	ZFP36L2_p.K155R
TTTGCTCACTCTCTACTACTACAT	CTACAaGACCGAGCTGTGC	ACGCGCTACAAGACCGAGCTGTGCCGGCCC	ZFP36L2_p.K155R
TTTGACATCGCTACATACATCAGC	GCGCAGATAGCGCGTATCA	ACGCAGCGCAGATAGCGCGTATCAAGGTGT	NT_nontargetX
TTTGCTCTCTACTACTACTAGCAT	GCGGaGGCGCAGGAGGAGG	ACGAGGCGGAGGCGCAGGAGGAGGAGGAGG	WRNIP1_p.E161G
TTTGGCATCACTACACACATACTC	GCGGaGGCGCAGGAGGAGG	ACGAGGCGGAGGCGCAGGAGGAGGAGGAGG	WRNIP1_p.E161G
TTTGCGACACTCACTCTACTATCG	GGAGaCTGCTGCGACCCCC	ACGACGGAGACTGCTGCGACCCCCAGGTGG	PAPPA2_p.D643G
TTTGTCTATCATCTCTACACGTCT	CGTGaGGAGTTTACAAGGT	ACCTTCGTGAGGAGTTTACAAGGTAGGCCA	EPB41L4B_p.E174G
TTTGTGACACTCACTAGCTACAGT	TGCCaCAAGGCTTTCGCCA	ACCTGTGCCACAAGGCTTTCGCCAAGGAGG	ZBTB7B_p.H436R
TTTGAGTCACTCTCACTGTCTAGT	TGCCaCAAGGCTTTCGCCA	ACCTGTGCCACAAGGCTTTCGCCAAGGAGG	ZBTB7B_p.H436R
TTTGTGTACTACTCACACATACGC	GTTGaGAAAGACGTCCCAG	ACCTGGTTGAGAAAGACGTCCCAGAGGTGG	KCNQ3_p.E283G
TTTGTATACACATCTACATCGTCG	GCCGaCCTGGTCTCGGAGA	ACCTGGCCGACCTGGTCTCGGAGATGGAGG	FGFR4_p.D476G
TTTGCATCTCTATGCACTATCATC	GACTaCTACTTGGGGGACA	ACCTGGACTACTACTTGGGGGACATGGAGG	TRIM41_p.Y135C
TTTGGCGTATATCTCACACACGCG	CTGTaTGTGAGCTGGAGGA	ACCTGCTGTATGTGAGCTGGAGGAAGGACC	ABCD4_p.Y108C
TTTGGTATGCTCTCTACACACTGT	CTGCaGGACCACCTGCTGC	ACCTGCTGCAGGACCACCTGCTGCAGGACC	KRTAP9-2_p.R15G
TTTGTCAGTCATATCACTCTGTAC	CACaGGACCAGTGAGAGGG	ACCTGCACAGGACCAGTGAGAGGGAGGCCA	GBP5_p.R356G
TTTGCTATCATCACACACTCTGCA	ACAGTaGCTATGGAGCTTG	ACCTGACAGTAGCTATGGAGCTTGTGGTGG	SETD2_p.S1277G
TTTGACATCACTAGTCACACTGCA	ACAGTaGCTATGGAGCTTG	ACCTGACAGTAGCTATGGAGCTTGTGGTGG	SETD2_p.S1277G
TTTGCACACAGATCATATCATCAT	TCAGaTGGGCTCAGGGCCG	ACCTCTCAGATGGGCTCAGGGCCGGGGCCC	ABCB10_p.D292G
TTTGATCATATCTACAGTACTCAC	AAGaCAGTCTCGGAGCTGC	ACCTCAAGACAGTCTCGGAGCTGCGGGGCA	OTOF_p.T9A
TTTGTATAGTATCACTCGTATCTA	GGACaCGGTAAGTGCAGTG	ACCGTGGACACGGTAAGTGCAGTGTGGCGC	PMPCA_p.T129A
TTTGTGTCAGCACACATACTACGA	TATaCCACCTCCCGCAGGC	ACCGCTATACCACCTCCCGCAGGCTGGATC	TMEM66_p.T53A
TTTGGACACTGTCGTCTATCTATC	TATaCCACCTCCCGCAGGC	ACCGCTATACCACCTCCCGCAGGCTGGATC	TMEM66_p.T53A
TTTGACATATCACTCTGCGTCTAT	AGCGaGGACGAGGAAGAGG	ACCGCAGCGAGGACGAGGAAGAGGAGGAGA	IRX5_p.E186G
TTTGTGTCTACAGTCTACACATCA	AGCCaGGAGCCAAGCCCAG	ACCGCAGCCAGGAGCCAAGCCCAGTGGGTT	GRAMD1A_p.Q264R
TTTGATGCTACTATCAGCTACAGT	ACAaGTGTGCATGTTCCAT	ACCGCACAAGTGTGCATGTTCCATTGGAGG	FRS2_p.S211G
TTTGCTACACAGTCACTATCTATG	ACAaGTGTGCATGTTCCAT	ACCGCACAAGTGTGCATGTTCCATTGGAGG	FRS2_p.S211G
TTTGTGCTACACACACAGTACACA	GATaCAAGGTAGCCTGTGC	ACCGAGATACAAGGTAGCCTGTGCTGGGGC	ALPL_p.Y263C
TTTGTCTAGACTACTCTCACAGTC	GATaCAAGGTAGCCTGTGC	ACCGAGATACAAGGTAGCCTGTGCTGGGGC	ALPL_p.Y263C
TTTGCAGCATCTCTGTCACGTCTA	TTGCaGTGGAGCCTCCTAG	ACCCTTTGCAGTGGAGCCTCCTAGTGGCCG	TMEM141_p.Q61R
TTTGGATCTACAGCTCTATATACT	ATGaGGTAACACCAAGCTC	ACCCTATGAGGTAACACCAAGCTCTGGGAG	DPH1_p.E367G
TTTGCGCTCACTCACTGCTACGAG	TGCaCGACGCTGCCCGGGA	ACCCGTGCACGACGCTGCCCGGGAGGGCTT	CDKN2A_p.A138A
TTTGATCTCATCTACTCATACAGC	TGCaCGACGCTGCCCGGGA	ACCCGTGCACGACGCTGCCCGGGAGGGCTT	CDKN2A_p.A138A
TTTGCTCTAGCATCTGCACACTCA	GTGGaCGAAAATGGTGCCA	ACCCGGTGGACGAAAATGGTGCCAAGGTGA	TIMM50_p.D195G
TTTGACATACGCACACTCACACAT	TACaGGGTCCTCAGAGGAG	ACCCCTACAGGGTCCTCAGAGGAGAGGGAG	TGM2_p.001
TTTGACACGCTCACACTCAGCACA	CTGGaCCTGCTGCCGTACT	ACCCCCTGGACCTGCTGCCGTACTCGGAGA	ZC3H7B_p.D350G
TTTGGTCACTATACTCGTCACGTC	CTGGaCCTGCTGCCGTACT	ACCCCCTGGACCTGCTGCCGTACTCGGAGA	ZC3H7B_p.D350G
TTTGAGTCATATATCAGTATCATA	CCaGGGAAGCCTGGGGCTT	ACCCCCCAGGGAAGCCTGGGGCTTTGGTCA	Q9H6S2_p.R1777G
TTTGCAGCACACTCTCTCTACGAT	TACTGaTGCTTGGAGGAGG	ACCATTACTGATGCTTGGAGGAGGTGGCTA	HDAC2_p.M298V
TTTGTCTCAGTATATCACGTCATC	CGCCaCTGCTTCCGGTGAG	ACCATCGCCACTGCTTCCGGTGAGTGGCCA	MICALL1_p.H187R
TTTGACATCTCATACTCACATCGT	CGCaTCAGGGCACTAAAGA	ACCATCGCATCAGGGCACTAAAGAGGGGAC	NUP210_p.I411V
TTTGCTCATGTCTGTCACTACATC	CTGTGaCACCAAGCTGCAG	ACCAGCTGTGACACCAAGCTGCAGGGGGCT	MRC2_p.D1235G
TTTGGCATCTCTGCTATCATCATA	CTCCaGCACGATGTCCGCC	ACCAGCTCCAGCACGATGTCCGCCTGGAAG	CCDC144NL_p.Q73R
TTTGACTACTGCTACACATCTCTG	CAGaTGCTGCTCCTGGGGG	ACCAGCAGATGCTGCTCCTGGGGGTGGCAG	BSN_p.D2339G
TTTGATGTCAGTCATCACAGTACT	ATGaGCAGCCGCGCGGCCT	ACCAGATGAGCAGCCGCGCGGCCTCGGCCA	TP73_p.S27G
TTTGCTAGCATCACATATATCTAC	ATGaGCAGCCGCGCGGCCT	ACCAGATGAGCAGCCGCGCGGCCTCGGCCA	TP73_p.S27G
TTTGCGATACTACTACACACGCAC	TGGGTaGGAGACCCACGGG	ACCACTGGGTAGGAGACCCACGGGGGGTGG	AQP1_p.001
TTTGTACTACGTCACTCTACAGAC	GGAAaCCTACATGGGCGAG	ACCACGGAAACCTACATGGGCGAGTGGAAG	JPH1_p.T280A
TTTGAGTCACATCGACACTCATAC	CAGTGaGAAGACAAAGGTA	ACCAACAGTGAGAAGACAAAGGTAGGGTGG	LRRC47_p.E468G
TTTGATAGTCTCACGTCACATCAC	ACATGaTGAAGTAGTATGT	ACCAAACATGATGAAGTAGTATGTGGGAGA	RIOK3_p.D167G
TTTGCAGTCACATCTCTACATCAG	TGTaGGTATGCCATTGCAT	ACATTTGTAGGTATGCCATTGCATTGGCCT	SKIV2L2_p.001
TTTGCGACACGCACTCTCACTCTA	TGTaGGTATGCCATTGCAT	ACATTTGTAGGTATGCCATTGCATTGGCCT	SKIV2L2_p.001
TTTGCTCTCATAGTACTACACACG	GAATaTGGAGCTGCTGTGC	ACATTGAATATGGAGCTGCTGTGCTGGTCC	KCNH1_p.Y374C
TTTGGCACTCTACTACTCATATAG	GGGCTaCCCCTTCCACGAC	ACATGGGGCTACCCCTTCCACGACGGGTAA	TM4SF4_p.Y129C
TTTGTCTACTACTCTGATCACATA	CTGGaGTTTCAAGACATCC	ACATGCTGGAGTTTCAAGACATCCGGGATG	ENC1_p.E128G
TTTGTCTAGTCACTCATCATCGCA	CTGGaGTTTCAAGACATCC	ACATGCTGGAGTTTCAAGACATCCGGGATG	ENC1_p.E128G
TTTGTCACATCTCTACACACTGCA	TACCaGCGCTTTCGAGTCT	ACATCTACCAGCGCTTTCGAGTCTTGGAGG	OLFML1_p.Q37R
TTTGCACATCGTCACTCTACTCAT	GGGaTGAGGAATGAGCAAG	ACATCGGGATGAGGAATGAGCAAGCGGTGA	HACL1_p.M57V
TTTGGCTATCATCACACTGTCTCA	GGGaTGAGGAATGAGCAAG	ACATCGGGATGAGGAATGAGCAAGCGGTGA	HACL1_p.M57V
TTTGACTACTGCACATACTATACA	GATAaGTCGCAGCTGACCG	ACATCGATAAGTCGCAGCTGACCGAGGACC	MCF2L_p.K177R
TTTGTCTGTACATACATCTCACTA	CTCaAGGTCTGGGACGGGC	ACATCCTCAAGGTCTGGGACGGGCCGGTGG	CSMD1_p.K1062E
TTTGATGATCACACATCAGCACTC	CGCTaTCGCCTGCAGGACG	ACATCCGCTATCGCCTGCAGGACGAGGGGA	FAT4_p.Y287C
TTTGTCTCTGCTCTATCAGCTCTA	AGGaTTTACAGTTAAGAAA	ACATAAGGATTTACAGTTAAGAAAAGGATG	ZNF493_p.D119G
TTTGTATCAGTCTATATCGTCGTC	GGGTGaGCAGACAGTTGTG	ACAGTGGGTGAGCAGACAGTTGTGCGGAGC	SBF2_p.E938G
TTTGATACACGTCTACATCGTACG	GCTaGAGTCTATGAAAACG	ACAGTGCTAGAGTCTATGAAAACGTGGGCC	PTPN11_p.R578G
TTTGGACTACTCTACTACAGTACT	GCTaGAGTCTATGAAAACG	ACAGTGCTAGAGTCTATGAAAACGTGGGCC	PTPN11_p.R578G
TTTGTACACACACTATCATCTCAT	CAGCaCTTCGAGAACTTCC	ACAGCCAGCACTTCGAGAACTTCCTGGAGA	CCM2_p.H385R
TTTGGTCACACTACTATCAGCACT	CACGaCCCGCACTCGGACG	ACAGCCACGACCCGCACTCGGACGAGGACA	POU3F3_p.D309G
TTTGCACGTCATCTCTATCTACGA	TGGaGGTTTTACTGGAAAA	ACAGATGGAGGTTTTACTGGAAAATGGTAT	XKR4_p.R290G
TTTGACAGCTCACATCACTATAGT	TCGAaTCAAAGTCAGAGTA	ACAGATCGAATCAAAGTCAGAGTATGGGAT	UNC13C_p.I1282V
TTTGCAGACTCTCACTCGCTCGTA	GTGAaTGACTTTTGGCGGA	ACACGGTGAATGACTTTTGGCGGATGGTGT	PTPN11_p.N339S
TTTGACTCTCTCGCTACTCGATCA	GTGAaTGACTTTTGGCGGA	ACACGGTGAATGACTTTTGGCGGATGGTGT	PTPN11_p.N339S
TTTGCTATATCAGTATATCTACAG	CATGaCTGCGCCGGTGTAC	ACACGCATGACTGCGCCGGTGTACTGGACG	SLC6A9_p.D155G
TTTGATATCATCTGCATCTCGCTC	TCCaCAGTGCTGACCACGA	ACACCTCCACAGTGCTGACCACGAAGGCCA	MUC5B_p.T4319A
TTTGGACAGCATCATCTATCGTAC	GGTAGTATTAATCGCTGAC	ACACCGGTAGTATTAATCGCTGACAGGCGG	NT_nontargetX
TTTGACAGCTCTACATACATAGTA	GACCTaAAGGATCAGACTG	ACACAGACCTAAAGGATCAGACTGTGGCAT	ALDH7A1_p.K437E
TTTGACACAGTCACATCTGTCATC	GGCaGCGGACGCCGCCTGC	ACAAGGGCAGCGGACGCCGCCTGCGGGACT	MNX1_p.S132G
TTTGTATATCACACTCATCGCTCT	ACAGaCTTGCTTGAGGAGA	ACAAGACAGACTTGCTTGAGGAGAAGGTGC	GNA13_p.D294G
TTTGCAGTATACTATCTATCATCT	ACAGaCTTGCTTGAGGAGA	ACAAGACAGACTTGCTTGAGGAGAAGGTGC	GNA13_p.D294G
TTTGATACATCATACATATATACT	TCTTCaATAAACGTGGGGA	ACAAATCTTCAATAAACGTGGGGAGGGCTC	CDKN2C_p.Q168R
TTTGGATCACTACACTACATCTCA	TCTTCaATAAACGTGGGGA	ACAAATCTTCAATAAACGTGGGGAGGGCTC	CDKN2C_p.Q168R
TTTGAGACATCATCTACTCTACGT	GCTGGaCCAGGAGGTAGAA	ACAAAGCTGGACCAGGAGGTAGAAGGGGGC	DOCK5_p.D1156G
TTTGAGAGTCACTCTATCATATCA	AAGAGaCCAGATACAACAT	AATTTAAGAGACCAGATACAACATAGGTTA	SPEF2_p.D831G
TTTGTCTCATATACACTCAGTATA	GAaTGGGATTAACAGGATT	AATTGGAATGGGATTAACAGGATTTGGAGT	GOLT1B_p.M12V
TTTGTCATCACTATGCTCTATCTC	AGaCAAGAATAGATACAGC	AATTGAGACAAGAATAGATACAGCAGGTAA	SPAG1_p.T193A
TTTGTGACATGCACTCTATATCGC	AGaCAAGAATAGATACAGC	AATTGAGACAAGAATAGATACAGCAGGTAA	SPAG1_p.T193A
TTTGCAGTCACAGTCTCATCGCTC	AAACaTCCTTCTATCTTGG	AATTGAAACATCCTTCTATCTTGGAGGTAA	PLK4_p.H69R
TTTGCTAGCACACACGCTATAGTC	AAACaAAACCTGATAGAAG	AATTGAAACAAAACCTGATAGAAGAGGTAA	MRTO4_p.Q24R
TTTGACGCACACTCACTCTGTATA	TCCaGGTGTTACAGAGCCA	AATTCTCCAGGTGTTACAGAGCCATGGACA	GSTA3_p.001
TTTGTACTCTACTCTATCATACGC	CAAGTaTAATGCAGAAAGT	AATTCCAAGTATAATGCAGAAAGTAGGTAA	PSEN1_p.Y315C
TTTGGACACTCTATACTACTCATC	GGCCCaTTAAAGCTGCTAT	AATTAGGCCCATTAAAGCTGCTATTGGAGA	CENPJ_p.I327V
TTTGACTCACATCTCACATATGAC	CACaTCAAGAGATGATAAA	AATTACACATCAAGAGATGATAAAAGGAAT	APIP_p.H137R
TTTGTGCTACGTCACACTCTCTCA	TGCaCGCATTAGTGAGGAT	AATGTTGCACGCATTAGTGAGGATAGGCAG	SLC25A30_p.H54R
TTTGATCATGATACATACTCTGTA	GACaCTGAGAATGAGGAGC	AATGTGACACTGAGAATGAGGAGCAGGAAG	TRIM37_p.T910A
TTTGCTGCTACGCACACTCATCGA	GAGaCAAAGACATTGGAGA	AATGCGAGACAAAGACATTGGAGAAGGAAG	DAAM2_p.T471A
TTTGGATACTATCATACACAGCAT	GACaGGTGATTCCCGTGGC	AATGCGACAGGTGATTCCCGTGGCTGGCCG	PFKFB3_p.R208G
TTTGCATACTGCTATCACTATCAT	AGCGaGAGGATTGCAGGGT	AATGCAGCGAGAGGATTGCAGGGTAGGTAT	UNC79_p.E170G
TTTGACACATCTAGCTCATATCGA	ACATaCTTATCCCTCAGGA	AATGAACATACTTATCCCTCAGGATGGTGA	CAP2_p.I442M
TTTGGCTAGCTCACATCATAGTCT	GCTaATGAGAAGGCTGAAC	AATCGGCTAATGAGAAGGCTGAACGGGAGG	KMT2D_p.N2807D
TTTGCAGTATATATCTACTACTCA	GCTaATGAGAAGGCTGAAC	AATCGGCTAATGAGAAGGCTGAACGGGAGG	KMT2D_p.N2807D
TTTGATCTATCTGCACTATCACTG	CCTGAaCTGAAACCACTGC	AATCCCCTGAACTGAAACCACTGCCGGAGG	AFF1_p.E316E
TTTGCTAGTCACGCACTCGCTCTC	CGCaCCACCACAGGCACGT	AATATCGCACCACCACAGGCACGTGGGCAG	PTPRT_p.T329A
TTTGGCAGCACACACTACTCAGCT	CGCaCCACCACAGGCACGT	AATATCGCACCACCACAGGCACGTGGGCAG	PTPRT_p.T329A
TTTGTATATCTACACATCATCTAC	GCCAGaTGCTGGTGTCTAA	AAGTTGCCAGATGCTGGTGTCTAAGGGCTA	RYR2_p.M2277V
TTTGTGACACTGCTACATCGCTAC	TGGaCGGGGACCAGGGGCT	AAGTGTGGACGGGGACCAGGGGCTGGGGAT	PAG1_p.D152G
TTTGCGCTACACATCATATCAGCG	TCCaTCCCTGATGAAGATG	AAGTGTCCATCCCTGATGAAGATGGGGAAA	C14ORF93_p.I107V
TTTGGACATACTCTATACTATCAG	CAGGaGGCAGATGAAGCCA	AAGTCCAGGAGGCAGATGAAGCCAAGGTGT	VARS_p.E1237G
TTTGCGTCACTGCTACATCGCTCT	TGGaTTGGAATGACTATTG	AAGTATGGATTGGAATGACTATTGAGGAAC	MTIF2_p.I95V
TTTGTACTCTCTACATATATCATA	GCGCaAGCGGTCGCCTGCG	AAGGTGCGCAAGCGGTCGCCTGCGGGGCTG	TNRC18_p.K1923E
TTTGATGCTACTATCACTGCTACT	AAAATaTGAAGTGCGTGCT	AAGGGAAAATATGAAGTGCGTGCTGGGGTT	SLC44A3_p.M233V
TTTGATAGCACACTGCATCACGAT	TACaATCTGAAAGATGAGG	AAGGCTACAATCTGAAAGATGAGGAGGGCC	PPP2R2B_p.N189D
TTTGTGCATCTCTCGCTACACATA	CTATaTGGGCTCATGTGGA	AAGGCCTATATGGGCTCATGTGGAAGGCAA	SYNPO2_p.M1191V
TTTGCTCTCTACTCACTACATCAT	CGAGaGGAGCTCATCAAGA	AAGGCCGAGAGGAGCTCATCAAGAAGGGGC	PHACTR3_p.E106G
TTTGATACATCACTATACTCGCTA	CAAGaAGAGCAGGTGCAGG	AAGGCCAAGAAGAGCAGGTGCAGGAGGCCA	ANK1_p.E1783G
TTTGCATACACACAGTATACTCGA	CAAGaAGAGCAGGTGCAGG	AAGGCCAAGAAGAGCAGGTGCAGGAGGCCA	ANK1_p.E1783G
TTTGACATGTCTCTATCACATACT	TGGGGaTGCATCAGGCCCA	AAGGATGGGGATGCATCAGGCCCAAGGGCT	MAST1_p.D872G
TTTGTCACTCGCTCTCTACAGTCT	GAaGCTGACTGTGCTGGAA	AAGGAGAAGCTGACTGTGCTGGAAAGGAGA	PHLDB1_p.K886R
TTTGCTCTCACAGATCTACTCTAT	GAACaGGTAAGAGGGGCCC	AAGGAGAACAGGTAAGAGGGGCCCAGGTAT	COL15A1_p.Q858R
TTTGGCTATCAGTATCACATCATG	CGAGCaAGGCCGGCTGCTG	AAGGACGAGCAAGGCCGGCTGCTGCGGCGC	BEST1_p.Q120R
TTTGATCACGTCTATATCATCATG	CCTCaCCGAGAAGGGTAGG	AAGCTCCTCACCGAGAAGGGTAGGTGGCTG	NUMA1_p.T245A
TTTGACTACTACTCATCTGCTCGA	TTaTGATTCTGCAGATGAC	AAGCCTTATGATTCTGCAGATGACTGGTCT	WAC_p.Y129C
TTTGTACTCACTACGTCACTCATG	TTAGCaGACCTGATTGAGA	AAGCCTTAGCAGACCTGATTGAGAAGGAAC	CNOT4_p.001
TTTGGTATATCATCATACACGCGT	GCCaGCCTCTACCAGTTCC	AAGCCGCCAGCCTCTACCAGTTCCAGGCCG	SPTBN2_p.S748G
TTTGCATCTCTCATCAGCATACGT	CTGTaCAGCAGCCTGTGGC	AAGCCCTGTACAGCAGCCTGTGGCAGGGGT	ADAMTSL3_p.T1610A
TTTGCGACACTCTCTCGCACGTCA	CCTGaGCAGCAATTTGAGG	AAGCCCCTGAGCAGCAATTTGAGGCGGCTG	LOC152485_p.S120G
TTTGCAGATCACTCACTCGATACA	CCTGaGCAGCAATTTGAGG	AAGCCCCTGAGCAGCAATTTGAGGCGGCTG	LOC152485_p.S120G
TTTGTGCATCTACTGCATCATCGA	CCTGCaGGCTGTGAAGGAG	AAGCACCTGCAGGCTGTGAAGGAGGGGCGC	CCDC40_p.Q1076R
TTTGTCATCATCGTCACATCAGAC	ATaCCTGACAGCAAAAGTC	AAGCAATACCTGACAGCAAAAGTCTGGAAT	RSPO3_p.I232M
TTTGTACTCTCACATGCACGCATA	GATaTCAAGAGGGTCATGG	AAGATGATATCAAGAGGGTCATGGCGGCGA	BCL7A_p.I18V
TTTGACACTCGCTCTACTCGTCTG	GAGGaGGAGGATGAGGGTA	AAGATGAGGAGGAGGATGAGGGTAAGGGCT	BRPF1_p.E471G
TTTGCACATCTGCTACACACACGC	GAGGaAAAAGAGGAAGAGG	AAGATGAGGAAAAAGAGGAAGAGGAGGCAG	RYR1_p.E1907G
TTTGTCAGCTACATCTACTCAGTA	ACAGaTACAGAATCCTACA	AAGATACAGATACAGAATCCTACAAGGAAA	ADAMTSL3_p.I1250V
TTTGCTGCTGCTATCTACTCTATC	TTAaTCGAATTAAAAGAGG	AAGAGTTAATCGAATTAAAAGAGGAGGAAG	MYST3_p.I1407V
TTTGGACTCTCTCACTACTGTACA	GAGGaGGAGGGGGGCAGCG	AAGAGGAGGAGGAGGGGGGCAGCGGGGCCT	C10ORF140_p.E427G
TTTGTGCACGTCACTCATCATATA	GAGGaGGAGGGGGGCAGCG	AAGAGGAGGAGGAGGGGGGCAGCGGGGCCT	C10ORF140_p.E427G
TTTGCATCAGCACATACATCTGAC	GAGaTaAGTGGCGCACTCC	AAGAGGAGATAAGTGGCGCACTCCCGGTGG	MTRR_p.I190M
TTTGCACATACATCAGCACTATAG	ATCaCCGTGCCGCTGTGTA	AAGAGATCACCGTGCCGCTGTGTAAGGGCA	FZD8_p.T39A
TTTGTCATACATCGACACACATCG	AAAaCCATTGCTATTGTGA	AAGAGAAAACCATTGCTATTGTGAAGGTTA	TFEC_p.T8A
TTTGCATATCATCAGATCACAGCT	CTGTaCAGAGATGAAAACT	AAGACCTGTACAGAGATGAAAACTTGGTGA	SERINC5_p.Y305C
TTTGGACACATGCACTATCACGAT	ACAGaAGTGAGGCCCCTGC	AAGACACAGAAGTGAGGCCCCTGCCGGTGC	ANKRD13B_p.K367E
TTTGAGACACTACACACTCTGCAT	GAGCTaTGACCGGCAGCGA	AAGAAGAGCTATGACCGGCAGCGATGGGGC	BCR_p.Y70C
TTTGGTCAGCACACTACTCTATCG	CTTaAGCGACTTCGGGGTG	AAGAACTTAAGCGACTTCGGGGTGAGGATA	CWF19L2_p.K50E
TTTGTACACTATCACTACTCTCAT	AGAGGaGGTATTGCAGGAG	AACTTAGAGGAGGTATTGCAGGAGTGGGAA	RCOR3_p.E339G
TTTGCTATCACTACATCAGTACTA	CAGaGGAGCGCCCAGCTCG	AACTGCAGAGGAGCGCCCAGCTCGTGGTAA	TNRC18_p.R928G
TTTGCATAGCACTACACACATAGA	GCATCaTGAGAAGAGTGTG	AACGAGCATCATGAGAAGAGTGTGAGGCAG	ITPR3_p.H704R
TTTGAGTACACTCATCTCTATATG	GTaAAGCCAAGAAGAAGAA	AACCTGTAAAGCCAAGAAGAAGAATGGAGA	MCM10_p.K391E
TTTGTACATCTCTGATCATCTATC	GGCTaCCTGGTGACCAAGG	AACCTGGCTACCTGGTGACCAAGGTGGTAG	PCDHGA5_p.Y586C
TTTGCTCATCATACATATCACTCG	TGCTaCAATGACATCAGAG	AACCCTGCTACAATGACATCAGAGTGGACC	PTPRO_p.T572A
TTTGTGCATCTCACTATCACACAG	TAGaAGATGCCTCTAATGG	AACCCTAGAAGATGCCTCTAATGGAGGAGT	TPCN1_p.E31G
TTTGATGCTCACTCATCTCATATA	GCTCaTCGCCGGCAAGTAG	AACCCGCTCATCGCCGGCAAGTAGGGGCCG	SNRPD2_p.I115V
TTTGACACACTCTCATCATACTAC	GAGGaGAGGCTACATGAGC	AACAGGAGGAGAGGCTACATGAGCAGGAGG	GOLGA6L10_p.E213G
TTTGACACTATCTACATCAGTAGT	CTGCaGCACCTGCTGAAGC	AACAGCTGCAGCACCTGCTGAAGCCGGTGA	ITPR3_p.Q2068R
TTTGATAGCACACACACTCACACG	CCAaTCGTCCAATAGCCGC	AACAGCCAATCGTCCAATAGCCGCTGGAGA	COQ2_p.N196S
TTTGCTCTATCACTGCACACGTCT	CTGaGAGAACTGCAGGACT	AACAACTGAGAGAACTGCAGGACTTGGTGA	TUBGCP4_p.R236G
TTTGCATGACACTCTGCACTCAGC	ACTCTaCGTGACGGGCGGG	AACAAACTCTACGTGACGGGCGGGCGGCGG	KLHL38_p.Y524C
TTTGTCATATCACTCATACTCTAT	TTATaGATGGAAAAAGTGG	AAATTTTATAGATGGAAAAAGTGGAGGCAG	CEP112_p.001
TTTGCGCATATATCACACTCAGAT	TTATaGATGGAAAAAGTGG	AAATTTTATAGATGGAAAAAGTGGAGGCAG	CEP112_p.001
TTTGGACAGCTACATCGTCTACAG	AGCCTaAACTGACTCCGTT	AAATGAGCCTAAACTGACTCCGTTGGGCCA	DHX29_p.K1065E
TTTGTCTGCTACACTATCTACTCA	AGGGCaAAGTGCAATTGCT	AAATCAGGGCAAAGTGCAATTGCTGGGGAA	WDR11_p.Q433R
TTTGTACACTATCATCATCTCAGT	AGGGCaAAGTGCAATTGCT	AAATCAGGGCAAAGTGCAATTGCTGGGGAA	WDR11_p.Q433R
TTTGTCATAGCTCACTACTCATGC	TGAGGaAAAATATACTTCC	AAATATGAGGAAAAATATACTTCCTGGAAA	CEP152_p.K919E
TTTGATAGACTCATCTCTACTCGC	TGAGaAACCCCGCCTACAG	AAAGTTGAGAAACCCCGCCTACAGGGGCAG	CD244_p.K131E
TTTGAGTCAGCTCGCACGTCTACT	GAAAaGGAGAGCTTGTTGA	AAAGTGAAAAGGAGAGCTTGTTGAAGGAAA	BACH1_p.K596R
TTTGTCTATCACATGTCACTGCAT	CATCaGTCCCTCTGAAGAC	AAAGTCATCAGTCCCTCTGAAGACAGGAAA	PRKCA_p.S319G
TTTGCGTCTATCTGCATATATCTC	TTTCGaTGACAGTGTGGGC	AAAGGTTTCGATGACAGTGTGGGCAGGAAC	SMG8_p.D428G
TTTGCTACACATCGCTGCATACAC	ACTTGaCAGGCGATGGCGA	AAAGGACTTGACAGGCGATGGCGACGGGGA	DNMT3B_p.T71A
TTTGTGTACACATCATACTATCGA	CATGaATGCAATAAATGTG	AAAGCCATGAATGCAATAAATGTGGGGAAA	ZNF667_p.E201G
TTTGAGTCTACTCGTATCTATCTG	TTCTaAGCCGCGTTCTTTG	AAAGATTCTAAGCCGCGTTCTTTGCGGTTC	MARK1_p.K696E
TTTGACTCGCTCACATCTCTATAC	TAAATaTGAAGAAAGCAGG	AAAGATAAATATGAAGAAAGCAGGCGGGAA	TACC2_p.Y2699C
TTTGCTACACATGTCATCACGCTA	AGGAAaCCCTGGGCCACTT	AAAGAAGGAAACCCTGGGCCACTTGGGCCA	COL5A2_p.N1189S
TTTGGCTCTCTACGTCATCTCTCT	AGAGGaTTTGTGGGGCGAG	AAAGAAGAGGATTTGTGGGGCGAGTGGAGC	IL27RA_p.D215G
TTTGTGTACATACATATATCGTCG	AGAGaAGCCTCGTAAAACC	AAAGAAGAGAAGCCTCGTAAAACCCGGGGC	ZNF22_p.K193E
TTTGGCTCACAGTCACGCTATCAG	AGAGaAGCCTCGTAAAACC	AAAGAAGAGAAGCCTCGTAAAACCCGGGGC	ZNF22_p.K193E
TTTGATATCTACGTATCACACTCG	ACTTaACTATAGAAGATCC	AAAGAACTTAACTATAGAAGATCCAGGTAA	RGS7_p.L70L
TTTGACAGTCACTCGCATATCGTC	TTGaATCCCGAATTCAATG	AAACCTTGAATCCCGAATTCAATGAGGTAA	RPH3A_p.N614D
TTTGGCACTACTCTCATCACTGCT	TTGaATCCCGAATTCAATG	AAACCTTGAATCCCGAATTCAATGAGGTAA	RPH3A_p.N614D
TTTGCGCACGTCACACATCGTCAC	CTCTaCGTCCCTAATCGGA	AAACCCTCTACGTCCCTAATCGGAAGGTGA	DCAF4L2_p.Y121C
TTTGATGCTCACGTCACTACACAT	GGTGaTCCAGGAGGGCAGC	AAACAGGTGATCCAGGAGGGCAGCTGGTGC	MOV10_p.D670G
TTTGTGCTATCTACTGCACTATAT	AAaGGaGATATCAAGAGGA	AAACAAAAGGAGATATCAAGAGGATGGATT	PTEN_p.R14G
TTTGGTACATCATCATCTATCGCT	AAaGGaGATATCAAGAGGA	AAACAAAAGGAGATATCAAGAGGATGGATT	PTEN_p.R14G
TTTGATAGTCAGTCTCATACGTCT	GCTCaGGCTATTGAGGACA	AAAATGCTCAGGCTATTGAGGACATGGTTG	PSMD1_p.Q527R
TTTGCAGCATACACTCATCATAGC	GACCaaTGAGCCCCCCAAA	AAAATGACCAATGAGCCCCCCAAAGGGCTC	DNAH3_p.N3633D
TTTGCTGCACACAGTCGTCTATCT	GACCaaTGAGCCCCCCAAA	AAAATGACCAATGAGCCCCCCAAAGGGCTC	DNAH3_p.N3633D
TTTGGACATCAGCACATACATCGT	AAGaAGACTAAGAATAAAA	AAAAGAAGAAGACTAAGAATAAAAAGGTAA	DZIP3_p.K664E
TTTGGTCAGTCTATACATCAGCGC	TCTaCCAAGGAGGATGCAC	AAAACTCTACCAAGGAGGATGCACTGGGCC	HSPA1L_p.Y613C
TTTGTCTGTACATCTATCACATGT	TATCTCGAGTGGTAATGCG	AAAACTATCTCGAGTGGTAATGCGAGGTCA	NT_nontargetX
TTTGCTATCATCTACACTCTGCGA	CTTCaGCAAAGGAGAGAGC	AAAACCTTCAGCAAAGGAGAGAGCCGGGGC	SASH1_p.S355G
TTTGAGACTCATATCATACACGTA	CGGCCaGCGTGATCACCAG	AAAACCGGCCAGCGTGATCACCAGCGGTGG	FZD10_p.S549G
TTTGCATACACATCACATCGCTCA	CCTaTGAGTGTAAGCAATG	AAAACCCTATGAGTGTAAGCAATGTGGGAA	ZNF20_p.Y283C
TTTGACGCACTCACACTCTCTCTA	TGCaCTCGGCTGTTGGGCA	AAAAATGCACTCGGCTGTTGGGCAAGGTAA	TBC1D1_p.H794R
TTTGCTGTCATCTACACTGCGTAT	TGCaCTCGGCTGTTGGGCA	AAAAATGCACTCGGCTGTTGGGCAAGGTAA	TBC1D1_p.H794R
TTTGACTCTCTACACGTCACTCTG	TGAaACCTGAACTACTGAG	AAAAATGAAACCTGAACTACTGAGTGGACA	MARVELD2_p.K420R
TTTGTCTGTCTATCGCTCTACTCG	TGAaACCTGAACTACTGAG	AAAAATGAAACCTGAACTACTGAGTGGACA	MARVELD2_p.K420R
TTTGAGATCATCACTCTGCATCAT	CCTaAGGTGTTCGTGACCG	AAAAACCTAAGGTGTTCGTGACCGAGGGAA	DNAH5_p.K112E
TTTGATAGCTCTATCACATACGTC	AGAATaATGTGGCTCTTGT	AAAAAAGAATAATGTGGCTCTTGTAGGAGT	ADAMDEC1_p.N343D
TTTGGATATCACACTCAGCTCACG	AATaTCATGGACCTGTATG	AAAAAAATATCATGGACCTGTATGTGGAGA	IL1F8_p.I91V
