Sorting_Barcode	GX19	Target	geneID
TTTGCAGTCGCAGTATATCTATG	GCCaaGTCTGTGACTTGCA	GGACAGCCAAGTCTGTGACTTGCACGGTCA	TP53_p.K120E
TTTGCTGTCATCTCGTCATCGAG	GCCaaGTCTGTGACTTGCA	GGACAGCCAAGTCTGTGACTTGCACGGTCA	TP53_p.K120E
TTTGGTCGTCATCATATATATCT	GGCaGCGGCAGCGGGCGGC	GCAGAGGCAGCGGCAGCGGGCGGCGGGCGC	FRMD4A_p.Q785R
TTTGTCAGTGTATCAGTACATCG	GGCaGCGGCAGCGGGCGGC	GCAGAGGCAGCGGCAGCGGGCGGCGGGCGC	FRMD4A_p.Q785R
TTTGGATATCGCATCATATACGT	GCCAaCGTGACCCTGTCCC	ACACGGCCAACGTGACCCTGTCCCTGGACA	KLHL14_p.N146S
TTTGTACATCATAGTCTATCAGC	GCCAaCGTGACCCTGTCCC	ACACGGCCAACGTGACCCTGTCCCTGGACA	KLHL14_p.N146S
TTTGGTCATGTGTATCAGTATCT	CCaCTGTCCCTGGCGCGCA	GCCGCCCACTGTCCCTGGCGCGCACGGCTA	SALL3_p.T533A
TTTGATCATGTGTCGTCATCTAC	CCaCTGTCCCTGGCGCGCA	GCCGCCCACTGTCCCTGGCGCGCACGGCTA	SALL3_p.T533A
TTTGTGAGTCATCATCACGTATC	GCGGCaGCGGCGGCGGCGG	CGGTAGCGGCAGCGGCGGCGGCGGCGGCCA	PRDM8_p.S289G
TTTGTCATCACAGAGAGTCATCT	GCGGCaGCGGCGGCGGCGG	CGGTAGCGGCAGCGGCGGCGGCGGCGGCCA	PRDM8_p.S289G
TTTGATATATCTATCAGCAGACA	TGTGTaACAGTTCCTGCAT	CTACATGTGTAACAGTTCCTGCATGGGCGG	TP53_p.N146D
TTTGCATCATCTCAGTATCGACT	TGTGTaACAGTTCCTGCAT	CTACATGTGTAACAGTTCCTGCATGGGCGG	TP53_p.N146D
TTTGGCATCTATCATCTATACTA	TGAGCaGCGGCGGCGGCGG	TCGGCTGAGCAGCGGCGGCGGCGGCGGCGG	SMG1_p.S12G
TTTGAGCATGTGTCGTCATCAGC	TGAGCaGCGGCGGCGGCGG	TCGGCTGAGCAGCGGCGGCGGCGGCGGCGG	SMG1_p.S12G
TTTGGAGTCATCACATAGTATAG	CGCaCGCCTGCCCCGAGTG	GCGGCCGCACGCCTGCCCCGAGTGCGGCAA	ZNF777_p.H750R
TTTGTCTATCTCTAGCATCATAT	CGCaCGCCTGCCCCGAGTG	GCGGCCGCACGCCTGCCCCGAGTGCGGCAA	ZNF777_p.H750R
TTTGTCATCAGCATCATCATCTG	ACCCaCTTGTCACCGGCCC	CGGCCACCCACTTGTCACCGGCCCTGGCCC	TRIM9_p.H112R
TTTGTCAGTATCTATATCATCTC	ACCCaCTTGTCACCGGCCC	CGGCCACCCACTTGTCACCGGCCCTGGCCC	TRIM9_p.H112R
TTTGTGTAGCATCATGTCATCGA	CAGACaCGCTGAGGTACTG	GCACCCAGACACGCTGAGGTACTGAGGGCG	C15ORF43_p.T47A
TTTGCACAGTATCTAGTAGCATA	CAGACaCGCTGAGGTACTG	GCACCCAGACACGCTGAGGTACTGAGGGCG	C15ORF43_p.T47A
TTTGATACTATCATCGCAGTACG	GGCaCCCACCAGCAGCTGC	AGCAGGGCACCCACCAGCAGCTGCTGGCCC	ABCB9_p.T723A
TTTGTATCACTATATCTAGTATA	GGCaCCCACCAGCAGCTGC	AGCAGGGCACCCACCAGCAGCTGCTGGCCC	ABCB9_p.T723A
TTTGGTCGCATCGCTATCATATA	CCAaCCTGGCGGCGCGCGG	CATGCCCAACCTGGCGGCGCGCGGGGGTGC	FRMD4A_p.N803S
TTTGCTCAGAGCATCGTCATAGT	CCAaCCTGGCGGCGCGCGG	CATGCCCAACCTGGCGGCGCGCGGGGGTGC	FRMD4A_p.N803S
TTTGGAGTATATCTAGTACTATC	CAGCaAGGCGCACGTGAGC	GGCCACAGCAAGGCGCACGTGAGCCGGATC	ITPRIPL2_p.K120E
TTTGAGTAGTCATCGAGTAGTCA	CAGCaAGGCGCACGTGAGC	GGCCACAGCAAGGCGCACGTGAGCCGGATC	ITPRIPL2_p.K120E
TTTGTACTAGTATCAGTATATCA	GCCAaTGCCTTGCGGGTCA	TCGTGGCCAATGCCTTGCGGGTCAAGGTGG	PLCB3_p.N726S
TTTGTAGTATCAGTCAGTACTAG	GCCAaTGCCTTGCGGGTCA	TCGTGGCCAATGCCTTGCGGGTCAAGGTGG	PLCB3_p.N726S
TTTGGTGTCACTACAGTATATCA	GCCaGCCCCCAGTTCGACC	GCGGCGCCAGCCCCCAGTTCGACCTGGACG	MAPK4_p.S534G
TTTGCATATCATCATCGTAGCAC	GCCaGCCCCCAGTTCGACC	GCGGCGCCAGCCCCCAGTTCGACCTGGACG	MAPK4_p.S534G
TTTGTGTCAGTGTATCTGTATAG	CTGCCaCTGCACCCCTGGC	GGGGCCTGCCACTGCACCCCTGGCTGGACT	MEGF11_p.H651R
TTTGTGAGTAGTCAGTAGTATAT	CTGCCaCTGCACCCCTGGC	GGGGCCTGCCACTGCACCCCTGGCTGGACT	MEGF11_p.H651R
TTTGCTACATCATCATCTACGTA	GGGaGAGACCGGCGCACAG	GTCCTGGGAGAGACCGGCGCACAGAGGAAG	TP53_p.R280G
TTTGATATGTATCATCTACAGTG	GGGaGAGACCGGCGCACAG	GTCCTGGGAGAGACCGGCGCACAGAGGAAG	TP53_p.R280G
TTTGACAGTGTATATCAGCAGAC	ACATCaGCACCAAGGCGGT	CAGGTACATCAGCACCAAGGCGGTGGGCAG	TGM3_p.S424G
TTTGCGTATCTATGTATCGTCTG	ACATCaGCACCAAGGCGGT	CAGGTACATCAGCACCAAGGCGGTGGGCAG	TGM3_p.S424G
TTTGTAGCATCATCATCACTGTA	GCGCaCGCCCTGGGCGGCA	CGCCCGCGCACGCCCTGGGCGGCATGGACG	CITED4_p.H127R
TTTGCGCTATCAGCATCTAGTCT	GCGCaCGCCCTGGGCGGCA	CGCCCGCGCACGCCCTGGGCGGCATGGACG	CITED4_p.H127R
TTTGCGCATCGCATCATATCGTG	GCTGCaCCGCGTCCATCAT	GCTGTGCTGCACCGCGTCCATCATGGGCCT	ADRA1A_p.T111A
TTTGGTCATATATCATACGTCAT	GCTGCaCCGCGTCCATCAT	GCTGTGCTGCACCGCGTCCATCATGGGCCT	ADRA1A_p.T111A
TTTGCTCATCACATATAGTATCA	AGTCAaCTTCATCAGCGCA	GCGCCAGTCAACTTCATCAGCGCAGGGCTC	TFIP11_p.N79S
TTTGCATCATATCATACTCAGTA	AGTCAaCTTCATCAGCGCA	GCGCCAGTCAACTTCATCAGCGCAGGGCTC	TFIP11_p.N79S
TTTGAGTCATCGCTATATCATAT	CGCCaCCACCCACTTCAGT	GCCGCCGCCACCACCCACTTCAGTTGGCCG	SLC35E4_p.H159R
TTTGTATATCGCATCATACGAGT	GGACaGCCGTCGCCCCCTC	GCCCCGGACAGCCGTCGCCCCCTCCGGAGG	SOX17_p.Q332R
TTTGACTATCTATCTCTAGCGTA	GGACaGCCGTCGCCCCCTC	GCCCCGGACAGCCGTCGCCCCCTCCGGAGG	SOX17_p.Q332R
TTTGTCACTCAGAGTAGTATATA	GTGGaCCGCTACGTGGCCG	TCAGCGTGGACCGCTACGTGGCCGTGGTGC	SSTR4_p.D143G
TTTGCATCGCTATATCATATATA	AGCCaGCACTGGGCAACCT	CTGTCAGCCAGCACTGGGCAACCTGGGCCC	ZER1_p.Q699R
TTTGGCACTAGTATATCAGCTAG	AGCCaGCACTGGGCAACCT	CTGTCAGCCAGCACTGGGCAACCTGGGCCC	ZER1_p.Q699R
TTTGTCTGTATATCATCTCTACG	GAGaCAGCCACCCCAGCGC	CTGCCGAGACAGCCACCCCAGCGCCGGTGG	HIST1H1B_p.T9A
TTTGGCGCATCTAGTCTATCATA	GAGaCAGCCACCCCAGCGC	CTGCCGAGACAGCCACCCCAGCGCCGGTGG	HIST1H1B_p.T9A
TTTGTACATCTGTCAGTATCATA	GCTGCaGGTAGCGGCCGCG	CAAGTGCTGCAGGTAGCGGCCGCGCGGGCC	SLC26A4_p.S55G
TTTGTATATCAGTATAGTACTAC	CGCaCTGGCGTCCGCACCC	AGATCCGCACTGGCGTCCGCACCCTGGCCG	UNC13D_p.T758A
TTTGATCATCTCATCACATACAT	CGCaCTGGCGTCCGCACCC	AGATCCGCACTGGCGTCCGCACCCTGGCCG	UNC13D_p.T758A
TTTGATGTCATCTATCATAGCAG	TCAaATACGCTGAGGACAT	GAAGTTCAAATACGCTGAGGACATGGGGCC	P2RX1_p.K369R
TTTGCGAGCATCTATCATCGCAT	TCAaATACGCTGAGGACAT	GAAGTTCAAATACGCTGAGGACATGGGGCC	P2RX1_p.K369R
TTTGCATCTATCTATAGTATCTA	TATaCCACCTCCCGCAGGC	ACCGCTATACCACCTCCCGCAGGCTGGATC	TMEM66_p.T53A
TTTGCTACATCATATCTATCGAT	TATaCCACCTCCCGCAGGC	ACCGCTATACCACCTCCCGCAGGCTGGATC	TMEM66_p.T53A
TTTGACATCATCATCTCACAGCG	GCTGCaCACGGTCAACTCC	CTGCGGCTGCACACGGTCAACTCCAGGCAC	ZFHX3_p.H1058R
TTTGTCAGAGAGTCATACGTATC	GCTGCaCACGGTCAACTCC	CTGCGGCTGCACACGGTCAACTCCAGGCAC	ZFHX3_p.H1058R
TTTGATCGACATCTATCATATAG	ACTaCAGTGTGTCACTGGT	GAGCAACTACAGTGTGTCACTGGTTGGCCC	PDLIM5_p.Y4C
TTTGTCAGCATGTGTCGCATCAT	ACTaCAGTGTGTCACTGGT	GAGCAACTACAGTGTGTCACTGGTTGGCCC	PDLIM5_p.Y4C
TTTGTCGTCAGCAGTATCGTATC	ACTCaGCCCTCAGCTGGAG	CGCGAACTCAGCCCTCAGCTGGAGCGGCTC	SPIRE2_p.S122G
TTTGGTCATCATACGTGTATCTC	ACTCaGCCCTCAGCTGGAG	CGCGAACTCAGCCCTCAGCTGGAGCGGCTC	SPIRE2_p.S122G
TTTGATGCATCACTATCATCTAG	CTCaACGACTACGGCGTGC	ACAATCTCAACGACTACGGCGTGCGGGAGC	NOD1_p.N716D
TTTGTCATCAGAGAGCATCTACG	CTCaACGACTACGGCGTGC	ACAATCTCAACGACTACGGCGTGCGGGAGC	NOD1_p.N716D
TTTGCTCATCATCTCACGTCATA	GCAaTGGCAGCCTTTGCAG	CCGACGCAATGGCAGCCTTTGCAGTGGAAC	NUP35_p.M1V
TTTGCTCAGATATCAGCATCATC	GCAaTGGCAGCCTTTGCAG	CCGACGCAATGGCAGCCTTTGCAGTGGAAC	NUP35_p.M1V
TTTGCAGAGCATCTATCATGTGT	TTCaGCCACTCCATGTTCA	TGTGGTTCAGCCACTCCATGTTCATGGGCT	BLCAP_p.S24G
TTTGTCTAGCATATATCTATCAT	GCCCAaCTGGGGGCCCAAG	CAGCAGCCCAACTGGGGGCCCAAGAGGACG	NRG1_p.T228A
TTTGGATCATATATCGCACTAGA	GCCCAaCTGGGGGCCCAAG	CAGCAGCCCAACTGGGGGCCCAAGAGGACG	NRG1_p.T228A
TTTGCTCAGTATCGTCAGTAGCA	TCCaTGTCCCCTGATGCCC	GCCATTCCATGTCCCCTGATGCCCAGGACG	COBLL1_p.M1158V
TTTGGCAGTATCTATGTAGCATC	TCCaTGTCCCCTGATGCCC	GCCATTCCATGTCCCCTGATGCCCAGGACG	COBLL1_p.M1158V
TTTGTCGACATCTATCATCTACG	ACCaaCCCTGTCAATGGCA	GCGACACCAACCCTGTCAATGGCAAGGCCA	NOTCH1_p.N390D
TTTGTCATCGTATAGTATCTATA	ACCaaCCCTGTCAATGGCA	GCGACACCAACCCTGTCAATGGCAAGGCCA	NOTCH1_p.N390D
TTTGCTCATCATCGTCATCATGA	AGGaTCGCTGCCGCCGCCT	GCTCCAGGATCGCTGCCGCCGCCTGGGCTC	DHX16_p.D630G
TTTGCACTATCTAGTATCTAGCG	CGACaTGGGCGCCGCCGCG	CGGGCCGACATGGGCGCCGCCGCGTGGGCA	POFUT1_p.M1V
TTTGATCGAGTAGTCATCTATCA	GCaGTGGCTCCAACCGTAG	TCGGAGCAGTGGCTCCAACCGTAGCGGCAG	DVL3_p.S576G
TTTGGTGTGTGTCAGTATCGCGT	CGAGCaAGGCCGGCTGCTG	AAGGACGAGCAAGGCCGGCTGCTGCGGCGC	BEST1_p.Q120R
TTTGGTCATAGCATCATCATGTC	CGAGCaAGGCCGGCTGCTG	AAGGACGAGCAAGGCCGGCTGCTGCGGCGC	BEST1_p.Q120R
TTTGCTAGTCATCATCATACGAC	GACCaAGCGACCAGCAGGT	AATCTGACCAAGCGACCAGCAGGTTGGTGC	NSD1_p.K2151E
TTTGAGTCTCACGTATCTATATA	GACCaAGCGACCAGCAGGT	AATCTGACCAAGCGACCAGCAGGTTGGTGC	NSD1_p.K2151E
TTTGTATGTCTATATATCTATAC	GACCaAGCGACCAGCAGGT	AATCTGACCAAGCGACCAGCAGGTTGGTGC	NSD1_p.K2151E
TTTGGCTAGTCAGTATATATCAT	GACCaAGCGACCAGCAGGT	AATCTGACCAAGCGACCAGCAGGTTGGTGC	NSD1_p.K2151E
TTTGTGTACAGCATCATCATACG	GGCCaaCACCTAGTCCAGG	GTCCCGGCCAACACCTAGTCCAGGTGGGTC	DMBT1_p.P1099P
TTTGATGTCATCTCGTCATACGC	CCCaGCACCCAACCCGGAC	GCCTCCCCAGCACCCAACCCGGACTGGCTC	FANCA_p.P1218P
TTTGCTCATCTATCATCACAGCT	CCCaGCACCCAACCCGGAC	GCCTCCCCAGCACCCAACCCGGACTGGCTC	FANCA_p.P1218P
TTTGCGTCTATCATGTAGCATCT	GCGCaGGTGCACATGGGCG	ATGCTGCGCAGGTGCACATGGGCGGGGCCA	PLXNB2_p.R1435G
TTTGATACATCATGTCGTCATCA	CGCTaTCGCCTGCAGGACG	ACATCCGCTATCGCCTGCAGGACGAGGGGA	FAT4_p.Y287C
TTTGAGTCACTCAGCATCTATAC	CGCTaTCGCCTGCAGGACG	ACATCCGCTATCGCCTGCAGGACGAGGGGA	FAT4_p.Y287C
TTTGTACTCACGTCTATCTCTAC	GGACCaCCCTGGGCACAGC	GAGCGGGACCACCCTGGGCACAGCAGGCAT	CCNL2_p.H512R
TTTGTAGTATCATCATCATGTCG	GCCCCaCAGCGCGCATCGG	CTGCAGCCCCACAGCGCGCATCGGCGGCAC	TBC1D9B_p.T1168A
TTTGGAGTCTCATCATCACATAC	AGACCaGCAACCTCTCACG	TGTGGAGACCAGCAACCTCTCACGTGGTCG	ZNRF3_p.S252G
TTTGATCATCGTATCAGCATATA	ACCaTGCTCATGGCCGTGC	GCCTCACCATGCTCATGGCCGTGCTGGTGC	ADCY5_p.M244V
TTTGTCAGTATCGTCTAGCATCT	GCCCaTGGTGAGTGGTGAC	GATTTGCCCATGGTGAGTGGTGACCGGATC	SCN1A_p.M1845V
TTTGATAGTCAGTGTAGTATATA	TTACGaGCGCAGCCTTGGC	AGTGCTTACGAGCGCAGCCTTGGCGGGCAG	IQSEC1_p.E394G
TTTGCACATCTCAGTACGTATAT	TGTCCaAAGAGTGAAGTTC	TCAGCTGTCCAAAGAGTGAAGTTCGGGCAA	SPOP_p.P94P
TTTGTCTGTCATCATCGTAGCTA	TGTCCaAAGAGTGAAGTTC	TCAGCTGTCCAAAGAGTGAAGTTCGGGCAA	SPOP_p.P94P
TTTGGTATAGTATAGTATATATA	TGTCCaAAGAGTGAAGTTC	TCAGCTGTCCAAAGAGTGAAGTTCGGGCAA	SPOP_p.P94P
TTTGTATCATCGCACTCATATAC	TGTCCaAAGAGTGAAGTTC	TCAGCTGTCCAAAGAGTGAAGTTCGGGCAA	SPOP_p.P94P
TTTGACAGATCATCGTCTACTAT	TTCaCAGGTGGGTGCTGCC	CCCGGTTCACAGGTGGGTGCTGCCTGGGCC	DNASE1_p.S65S
TTTGACAGTCTCTATCGCAGTAC	ACCaCACCATTATGACCAT	GTGCAACCACACCATTATGACCATTGGCAC	FUT1_p.H302R
TTTGTATCATACATATAGTCTAG	ACCaCACCATTATGACCAT	GTGCAACCACACCATTATGACCATTGGCAC	FUT1_p.H302R
TTTGCATATCATGTGTCATACTA	CGCCaCCCCGCAGGTACGG	GGGACCGCCACCCCGCAGGTACGGGGGCGG	SRSF2_p.P106P
TTTGGATCACAGAGAGTAGTCTA	CGCCaCCCCGCAGGTACGG	GGGACCGCCACCCCGCAGGTACGGGGGCGG	SRSF2_p.P106P
TTTGATCGTCATACTCTATCGCA	CGCCaCCCCGCAGGTACGG	GGGACCGCCACCCCGCAGGTACGGGGGCGG	SRSF2_p.P106P
TTTGTGTCTAGTAGTCGCATATA	CGCCaCCCCGCAGGTACGG	GGGACCGCCACCCCGCAGGTACGGGGGCGG	SRSF2_p.P106P
TTTGATATATCTATCATAGTCAG	CCCaTCGTGCAGTGCGCCG	GCGCCCCCATCGTGCAGTGCGCCGTGGCCG	CPSF1_p.I646V
TTTGATCAGTGTGTGTAGTCAGT	CCCaTCGTGCAGTGCGCCG	GCGCCCCCATCGTGCAGTGCGCCGTGGCCG	CPSF1_p.I646V
TTTGGTCGTCATCATGTCATCTC	CGGaGGAGGTGGCGGCGGC	CTCTCCGGAGGAGGTGGCGGCGGCGGGGGG	LEF1_p.G6G
TTTGGAGTGTATCTAGTATAGAG	CGGaGGAGGTGGCGGCGGC	CTCTCCGGAGGAGGTGGCGGCGGCGGGGGG	LEF1_p.G6G
TTTGCGTCACGTCATACTCATCT	GTTCaCCAACGCCATTCGT	GCGGAGTTCACCAACGCCATTCGTCGGTAA	MCC_p.T724A
TTTGTCAGTATCTCTACATCTAC	GTGGCaGTGGCGGCGGCGG	CGGCGGTGGCAGTGGCGGCGGCGGCGGCGG	ZFHX3_p.S3513G
TTTGTCATCTATCATCACATAGC	GTGGCaGTGGCGGCGGCGG	CGGCGGTGGCAGTGGCGGCGGCGGCGGCGG	ZFHX3_p.S3513G
TTTGTCTCATCATCAGCATACGC	GTGGCaGTGGCGGCGGCGG	CGGCGGTGGCAGTGGCGGCGGCGGCGGCGG	ZFHX3_p.S3513G
TTTGGAGTCATATGTAGTCAGTC	GTGGCaGTGGCGGCGGCGG	CGGCGGTGGCAGTGGCGGCGGCGGCGGCGG	ZFHX3_p.S3513G
TTTGCTCGTCATCTCATCGAGCT	CTACTaCTTTGACTACCTG	GGCCACTACTACTTTGACTACCTGGGGAAC	TPCN2_p.Y433C
TTTGTCACAGTATCGCGTAGCTA	AGTaCAAGGCTGCGGCTGG	GCGTCAGTACAAGGCTGCGGCTGGCGGAGC	KIF26A_p.T1779A
TTTGAGTATCAGAGATCTATCAC	AGTaCAAGGCTGCGGCTGG	GCGTCAGTACAAGGCTGCGGCTGGCGGAGC	KIF26A_p.T1779A
TTTGACTATCATCAGCTATCTGT	GCGCAaCCTCTCGCTGGAC	GCTCTGCGCAACCTCTCGCTGGACCGGCGC	ARVCF_p.N735S
TTTGTCTACAGTGTATATCATCT	GCGCAaCCTCTCGCTGGAC	GCTCTGCGCAACCTCTCGCTGGACCGGCGC	ARVCF_p.N735S
TTTGAGTGTACATATCAGCATCA	AGTaCCGGCGGACACAGCC	GCATCAGTACCGGCGGACACAGCCAGGTTG	FNDC3B_p.T652A
TTTGCACTCACAGAGCATCGTCA	AGTaCCGGCGGACACAGCC	GCATCAGTACCGGCGGACACAGCCAGGTTG	FNDC3B_p.T652A
TTTGTATCTATCGTCTAGCAGAC	TGCaGGCCGGGGCCACGCT	ACTCCTGCAGGCCGGGGCCACGCTAGGCAC	ZNF407_p.Q2201R
TTTGTGTGTCATCATAGTCTCTA	TGCaGGCCGGGGCCACGCT	ACTCCTGCAGGCCGGGGCCACGCTAGGCAC	ZNF407_p.Q2201R
TTTGTCACATCACAGAGTCTATG	TCCCCaCCGCAGCTGCGTT	GTACATCCCCACCGCAGCTGCGTTTGGCGG	SEC61A2_p.T419A
TTTGCTGTCATCATACAGTAGTA	TCCTCaTCAGCACCGTGGC	CCTCCTCCTCATCAGCACCGTGGCCGGGGG	IMP5_p.I16V
TTTGAGTCACATATCGTATAGTC	GCCCaAGGCCACACCCTGC	TGCAGGCCCAAGGCCACACCCTGCAGGTGA	ALDH16A1_p.Q641R
TTTGTGTCATCTACATCATACAT	GCCCaAGGCCACACCCTGC	TGCAGGCCCAAGGCCACACCCTGCAGGTGA	ALDH16A1_p.Q641R
TTTGCATCATACATCTAGTCTAC	GGAaGGCGGGGACCCTGCA	CATCAGGAAGGCGGGGACCCTGCACGGCTT	PRMT2_p.K332R
TTTGATGTCACTCAGAGAGTACA	GGAaGGCGGGGACCCTGCA	CATCAGGAAGGCGGGGACCCTGCACGGCTT	PRMT2_p.K332R
TTTGGCTCACATCATCACGTATC	CGCaTGCAGGCCAGCTACC	AGGCACGCATGCAGGCCAGCTACCGGGAGC	RRBP1_p.M329V
TTTGCTATATCACTATCTACAGA	CAGaCGCTGCAGCGCTCAC	TCTCCCAGACGCTGCAGCGCTCACTGGCCA	RHPN1_p.T443A
TTTGTATCGTCATCTATCAGCAC	CAGaCGCTGCAGCGCTCAC	TCTCCCAGACGCTGCAGCGCTCACTGGCCA	RHPN1_p.T443A
TTTGCGTCAGCAGTAGTATAGTC	AGGaCGACGAGCTGGCAGG	AGGCGAGGACGACGAGCTGGCAGGCGGCCC	PURB_p.D197G
TTTGATGTAGCTCATAGCATCTA	TACTaCCGCAGTGCCAATG	AGAGCTACTACCGCAGTGCCAATGGGGCCA	RAB43_p.Y88C
TTTGGCTGTATCATCTATCAGCA	TACTaCCGCAGTGCCAATG	AGAGCTACTACCGCAGTGCCAATGGGGCCA	RAB43_p.Y88C
TTTGATCAGAGCATCTACTATCG	GGCCaTCTTCCTCGAGGCA	TCTGAGGCCATCTTCCTCGAGGCAAGGCCC	PRPF6_p.I818V
TTTGATGTATCTATCACAGTAGT	CCCaCATCCTGCCAGGCAT	GGAGGCCCACATCCTGCCAGGCATAGGGCA	EPHX3_p.H330R
TTTGTGTCTCATCATCTCACGTA	CCCaCATCCTGCCAGGCAT	GGAGGCCCACATCCTGCCAGGCATAGGGCA	EPHX3_p.H330R
TTTGCATCTCATAGCATCATCTC	CTaCCGCCTCTCAGTGTCC	GACGCCTACCGCCTCTCAGTGTCCCGGGCT	PTGFRN_p.Y230C
TTTGTCATCACAGCATCTACATG	CCTGCaTGGCGATGCCAGC	ATCTACCTGCATGGCGATGCCAGCCGGCCC	TNN_p.H1089R
TTTGATATGTATCAGTAGAGTAT	GCTaCAGATACTGAGAGGC	ATGTTGCTACAGATACTGAGAGGCTGGAGT	LRBA_p.T1251A
TTTGCATGACATCTATCGTCTAG	CCCCCaCAACCTCACATGC	GGCACCCCCCACAACCTCACATGCCGGGCC	KIRREL_p.H139R
TTTGTCTATCTATCAGTCACTAG	AGTTCaTGTGCCAATGGTG	CAAGCAGTTCATGTGCCAATGGTGCGGCAA	ZBTB47_p.M605V
TTTGTGTAGTCAGTCAGTAGTAG	CTCaCGCCCACCCACGTCA	AGTCGCTCACGCCCACCCACGTCACGGCTG	MAP3K10_p.T811A
TTTGCATCGCATAGCATCTATCG	TGCaCGACGCTGCCCGGGA	ACCCGTGCACGACGCTGCCCGGGAGGGCTT	CDKN2A_p.A138A
TTTGCACTGTATCGCAGTACGTC	TGCaCGACGCTGCCCGGGA	ACCCGTGCACGACGCTGCCCGGGAGGGCTT	CDKN2A_p.A138A
TTTGAGTATCAGAGTCATCGTAG	TGCaCGACGCTGCCCGGGA	ACCCGTGCACGACGCTGCCCGGGAGGGCTT	CDKN2A_p.A138A
TTTGTCATATGTCTATCATATCG	TGCaCGACGCTGCCCGGGA	ACCCGTGCACGACGCTGCCCGGGAGGGCTT	CDKN2A_p.A138A
TTTGCATAGTCATCGTATCTAGC	CGGGCaCACTGAAATCGCG	TACTGCGGGCACACTGAAATCGCGCGGCTC	ANKRD39_p.H109R
TTTGCGTCTGTCATATGTCTATC	GGGTCaTGACCATCGGGCC	TCCTGGGGTCATGACCATCGGGCCTGGTGA	HNF1A_p.M295V
TTTGGTATCAGAGAGTATAGTCT	GGCaCCCGCGTCCGCGCCA	CGCCCGGCACCCGCGTCCGCGCCATGGCCA	TP53_p.T155A
TTTGCAGCATGTGTATCGTCACA	GGCaCCCGCGTCCGCGCCA	CGCCCGGCACCCGCGTCCGCGCCATGGCCA	TP53_p.T155A
TTTGAGTAGTCGTCATCTCATAC	TCAGaGCACCGGCTGGGCA	CCACGTCAGAGCACCGGCTGGGCAAGGACT	PLXNA4_p.E1786G
TTTGTATGTCAGCAGTAGTAGTC	GAAaCGGTAAGAGTGAGTC	AGGATGAAACGGTAAGAGTGAGTCCGGGGC	MYO5B_p.T46A
TTTGCATCTATCGCTCATCTACG	GAAaCGGTAAGAGTGAGTC	AGGATGAAACGGTAAGAGTGAGTCCGGGGC	MYO5B_p.T46A
TTTGCGATCGCATAGCATATCTA	GCACCaAGCGCAGCAACAC	GGTCTGCACCAAGCGCAGCAACACGGGAGG	NOVA2_p.K23E
TTTGCATATCATCTCTATCGAGT	GACTaCGTGTACCGCCAGG	TGCGGGACTACGTGTACCGCCAGGAGGCCC	DCST1_p.Y362C
TTTGTAGTATCAGTAGTCATCGT	ATGGaGAAGGGTGTTAAGG	CCTGCATGGAGAAGGGTGTTAAGGTGGTGG	GAPDHS_p.E96G
TTTGGTGTGTCTACGTATCTATA	ATGGaGAAGGGTGTTAAGG	CCTGCATGGAGAAGGGTGTTAAGGTGGTGG	GAPDHS_p.E96G
TTTGGCATCACTAGTATCAGTAT	AAGGaCCGCACCAAGGGCC	CGGACAAGGACCGCACCAAGGGCCCGGCCG	KCNQ2_p.D603G
TTTGCTCTATCGAGATCATCTAT	TTGTaTCACCGTCCAGGTG	CCGGGTTGTATCACCGTCCAGGTGAGGCTT	TCTA_p.Y68C
TTTGGTCAGTGTATCATACGTAC	CCaCCGCCGCCGCTCGGTG	GGCAGCCACCGCCGCCGCTCGGTGCGGCTC	MTO1_p.T53A
TTTGCATCGCACTCATCGTCACG	GGaTGCAGGCATGCAGTCC	GAGCTGGATGCAGGCATGCAGTCCCGGACC	KALRN_p.D2135G
TTTGCTACATATATCAGTATCTC	TACaCTGTCGTGCAACCAG	CCGTGTACACTGTCGTGCAACCAGTGGGGC	CCKBR_p.T193A
TTTGATATATCACAGAGCATCAT	CCTGCaCTGTCACCTGTGC	GTCGGCCTGCACTGTCACCTGTGCCGGTGG	THBS2_p.T507A
TTTGCGAGTCATCACTAGTAGCA	TGGaGCAGCTGTGTCAGGC	GCGGCTGGAGCAGCTGTGTCAGGCGGGTGG	NOTCH3_p.E1052G
TTTGTAGAGTCATCGAGTCATCA	AGCaCCAGGTTGTCCACAC	CGCCCAGCACCAGGTTGTCCACACAGGGGC	ZSCAN22_p.H314R
TTTGAGTCAGATCATATATCTCG	AGCaCCAGGTTGTCCACAC	CGCCCAGCACCAGGTTGTCCACACAGGGGC	ZSCAN22_p.H314R
TTTGCATATGTATCAGAGTATCG	GTaTGACCACAGTGGGGTA	CGTCAGTATGACCACAGTGGGGTACGGGGA	KCNS2_p.M372V
TTTGAGTGTATCAGTAGCATCTA	GTaTGACCACAGTGGGGTA	CGTCAGTATGACCACAGTGGGGTACGGGGA	KCNS2_p.M372V
TTTGCGCACTCACGTCAGCATCG	TGCACaTCGCCTCCCGCAG	GCCACTGCACATCGCCTCCCGCAGGGGCAA	ANK1_p.I245V
TTTGGTCTATGTATATCTACGTA	TGCaGGTGCCAGTGCCGCC	CCAGCTGCAGGTGCCAGTGCCGCCTGGGTA	C8A_p.R516G
TTTGGTCTATCATGTAGTCAGAG	TCTaGGAGTGCCGTTCTGC	TGAGCTCTAGGAGTGCCGTTCTGCTGGTCG	CNPY1_p.*93W
TTTGAGTGTCGTCAGTATCTATC	TCTaGGAGTGCCGTTCTGC	TGAGCTCTAGGAGTGCCGTTCTGCTGGTCG	CNPY1_p.*93W
TTTGAGTGTATCATATATAGCTC	TCTaCCCACGGCCCGACTT	GGGGCTCTACCCACGGCCCGACTTCGGTGA	HOXD4_p.Y52C
TTTGCACATCATACTCAGCATCG	GACaCTGCCCCTGCAAGAC	CCACAGACACTGCCCCTGCAAGACTGGGAA	CDHR3_p.H741R
TTTGGATCATATCATCGCATCAC	CGGCaGCGGCGGCAGCTGG	GGCAGCGGCAGCGGCGGCAGCTGGAGGCCT	PHOX2B_p.A256A
TTTGTCATAGTCATCGAGTCATA	CCAGaATCAGCGAGCCAAG	TGGTTCCAGAATCAGCGAGCCAAGTGGCGG	ISX_p.N132D
TTTGATGTCATCGCGTAGCTATA	GGAaCAGCCCCATGCCCCT	GACAAGGAACAGCCCCATGCCCCTGGGCAC	ACTL7B_p.N5S
TTTGTATCATCTAGTACAGAGCA	GGAaCAGCCCCATGCCCCT	GACAAGGAACAGCCCCATGCCCCTGGGCAC	ACTL7B_p.N5S
TTTGAGTGTGTCATCATATATCG	ACCaCCACCGAGACCTACA	ACGCCACCACCACCGAGACCTACATGGGCG	JPH2_p.T287A
TTTGTCATCTATCATCTATCGCA	GCGAaCCCCGAGGCCATGC	TCGCAGCGAACCCCGAGGCCATGCTGGACC	ZNF236_p.N815S
TTTGTATGTCAGTCAGTATCGAT	GCGAaCCCCGAGGCCATGC	TCGCAGCGAACCCCGAGGCCATGCTGGACC	ZNF236_p.N815S
TTTGCAGTCATCATCATGTCGCT	CACTaCTCGCTGGCCACGC	ACTTCCACTACTCGCTGGCCACGCAGGTGC	NRG2_p.Y609C
TTTGCTATCAGCATATATCGTAT	CAAGGaATTGGGCCAGACA	GTGGCCAAGGAATTGGGCCAGACAGGGACA	AUP1_p.E251G
TTTGTCATGTATATCAGTCAGAC	TGTaCCAAGTGTGGCGTCG	ACATGTGTACCAAGTGTGGCGTCGGGGCAC	VAV2_p.T545A
TTTGGTCGTCAGTCAGTATCACT	GCAGTaGCGGGGGACTCGA	AGGAGGCAGTAGCGGGGGACTCGATGGACC	PAN3_p.S134G
TTTGCATACATCATGTCGCATCT	GCAGTaGCGGGGGACTCGA	AGGAGGCAGTAGCGGGGGACTCGATGGACC	PAN3_p.S134G
TTTGTGACAGTCAGTAGCTATAT	CAGaCATGCCACGGAGCCC	TGCCTCAGACATGCCACGGAGCCCTGGTGC	BSN_p.D1516G
TTTGTGATATATCAGTATATATC	AGACTaCGTGTGCGTGGTG	GAGCGAGACTACGTGTGCGTGGTGAGGGCA	BCAM_p.Y123C
TTTGGTCATCGCATCGCATATCT	CACGaCGTGCGGGTGGCGG	CCGCCCACGACGTGCGGGTGGCGGTGGTGC	COL6A1_p.D870G
TTTGTCGAGCATCATCATACGTC	GCCCaCATTGCCAGGGCTG	GCATTGCCCACATTGCCAGGGCTGTGGAAC	GPBAR1_p.T70A
TTTGATCAGCAGTATAGTAGTCA	GCCCaCATTGCCAGGGCTG	GCATTGCCCACATTGCCAGGGCTGTGGAAC	GPBAR1_p.T70A
TTTGTCAGATATCATCATCACAT	CCCCaTGAGGGGTGAGGAG	TGCAACCCCATGAGGGGTGAGGAGTGGTTC	FSCN3_p.M251V
TTTGGTCAGTATCTCAGCGTATC	CGCCaCGGCCTGCTGCTGC	CGAGCCGCCACGGCCTGCTGCTGCCGGCCT	FAM122A_p.H69R
TTTGATGTCGCATCTACGTATCT	GGaCTGCAAGGTCCGAGCC	GCGGTGGACTGCAAGGTCCGAGCCCGGGGA	ITM2B_p.D37G
TTTGCTCATGTATATATCGCAGT	AGAGGaGCCACACTCTGAC	TCCCCAGAGGAGCCACACTCTGACAGGTGA	FAM134A_p.E135G
TTTGCATAGTCATCGTAGCATCT	GCaGCTCCGCAGCCACTGC	GCACAGCAGCTCCGCAGCCACTGCTGGTCT	BAIAP3_p.S717G
TTTGACATATATAGCATCTACAT	TCaACCGAGTAGTGTCTCC	CAGTGTCAACCGAGTAGTGTCTCCCGGACC	SLC25A36_p.N57D
TTTGTCATCATGTCAGTCTAGAG	TCaACCGAGTAGTGTCTCC	CAGTGTCAACCGAGTAGTGTCTCCCGGACC	SLC25A36_p.N57D
TTTGTATACGTCTATCATCGCTA	TGCCTaTGTCGCGGCGTGG	CACAATGCCTATGTCGCGGCGTGGCGGTTT	FAM171A1_p.Y241C
TTTGTAGTATCGTCATACGTATC	TGCCTaTGTCGCGGCGTGG	CACAATGCCTATGTCGCGGCGTGGCGGTTT	FAM171A1_p.Y241C
TTTGTACGCATCGTCTATCTATC	CCATGaCCGCCGCCAGTAT	GCCAACCATGACCGCCGCCAGTATGGGCCC	CTGF_p.T2A
TTTGAGTGTCAGTATATATCTAC	CCATGaCCGCCGCCAGTAT	GCCAACCATGACCGCCGCCAGTATGGGCCC	CTGF_p.T2A
TTTGTAGAGTGTCACTATCGCAT	TTGTCaTGGACCTGCTTTG	GCAGCTTGTCATGGACCTGCTTTGTGGTCA	SACS_p.H1371R
TTTGATGTGTGTAGTCTCGCATA	ACATCaACGGCCTGACGCT	CACCTACATCAACGGCCTGACGCTGGGCTG	MPV17L2_p.N172D
TTTGTGAGTCTCATAGTCATCAC	AGCaCAGCTACTCGCACGG	CCAGGAGCACAGCTACTCGCACGGCGGCGG	MXD3_p.T222A
TTTGTGTGTATCATCATCTACAC	GAGCaCATCTCGCTGGCCC	AGTCGGAGCACATCTCGCTGGCCCAGGTGT	ABCA2_p.H2325R
TTTGAGTCACTCATCTCAGCATA	TGGaCGCGGCTTAACGTCC	AGCCCTGGACGCGGCTTAACGTCCGGGACA	TRIM62_p.T405A
TTTGGCATCATCATCACTATAGT	TGCaCCGCGCCTGCCGCGA	CCCGCTGCACCGCGCCTGCCGCGACGGGGA	ANKRD10_p.H27R
TTTGCTCATCGCATCATACGCAT	AGCaCGAGAACGCACCAGG	GCACGAGCACGAGAACGCACCAGGTGGGCC	PRDM16_p.H1032R
TTTGTATCGCTATCAGCATCTAG	AGCaCGAGAACGCACCAGG	GCACGAGCACGAGAACGCACCAGGTGGGCC	PRDM16_p.H1032R
TTTGTGATCATCGCAGTATCATC	CCCaGTGCGTGGTGGTCGC	CCGCACCCAGTGCGTGGTGGTCGCCGGCTC	LPHN1_p.Q101R
TTTGGTCATCGTCTAGTATCAGA	CCCaGTGCGTGGTGGTCGC	CCGCACCCAGTGCGTGGTGGTCGCCGGCTC	LPHN1_p.Q101R
TTTGGTAGTATATATCACTATCG	TCTGGaGGTGGGCCCAGGG	GTCATTCTGGAGGTGGGCCCAGGGCGGGCA	DCAF15_p.E480G
TTTGCTCAGAGTCTAGTATCGCA	TCTGGaGGTGGGCCCAGGG	GTCATTCTGGAGGTGGGCCCAGGGCGGGCA	DCAF15_p.E480G
TTTGGTCATCTATGTATCGCAGC	GGCaCCGTGCGCCCAGCTC	CTTCCGGCACCGTGCGCCCAGCTCAGGTCA	ETV7_p.H97R
TTTGGAGTGTATATCTATAGTAG	GACTaCCACGACCTGGAGT	AAAGCGACTACCACGACCTGGAGTCGGTGG	SDCCAG3_p.Y317C
TTTGCTGTCTCTCATCATACGTC	GATCaCCGTGTACTGCGTG	ATGCTGATCACCGTGTACTGCGTGCGGAGG	DDI1_p.T4A
TTTGTACAGCATCATCATACGCT	GATCaCCGTGTACTGCGTG	ATGCTGATCACCGTGTACTGCGTGCGGAGG	DDI1_p.T4A
TTTGATGTGTAGTACGTCTAGCT	GTGAaCACCATGGCCAGCT	GTGGCGTGAACACCATGGCCAGCTCGGCGG	CTSF_p.N475S
TTTGATAGTCATCGAGTAGTCTA	CAGGaAGCTGAATGTCCAG	CGGAGCAGGAAGCTGAATGTCCAGAGGATG	ZNF462_p.E1441G
TTTGTCACTAGTCAGCATCATAT	CGGCCaCTACCGCTTCACG	GTGCCCGGCCACTACCGCTTCACGTGGACG	KCNN1_p.H221R
TTTGCATATATCGTCAGCAGTAT	CGGCCaCTACCGCTTCACG	GTGCCCGGCCACTACCGCTTCACGTGGACG	KCNN1_p.H221R
TTTGGTCTCGTCATCATCGACTC	GTaCACGGGCCGGCGGGGT	CGGCTGTACACGGGCCGGCGGGGTCGGGGC	IMPA2_p.Y142C
TTTGTGTCAGTATCATCATCGTC	GTaCACGGGCCGGCGGGGT	CGGCTGTACACGGGCCGGCGGGGTCGGGGC	IMPA2_p.Y142C
TTTGGTCATCGTCAGTAGCGTAT	AGCACaGACAGTTGGACGA	GACACAGCACAGACAGTTGGACGAAGGCTC	ULK2_p.Q461R
TTTGCTATCAGTCAGTATATCTG	GCTaTGAGAGGGCGTCCCA	TGGACGCTATGAGAGGGCGTCCCAGGGCCC	SLC15A3_p.Y563C
TTTGGTCATGTCAGTAGTCTATA	TCCaCGGCACCCCCACTGC	CGCTCTCCACGGCACCCCCACTGCAGGCTG	SLX4_p.H588R
TTTGCAGTCATCTAGTACATACG	GGTCTaCAACGTGCTGGAG	AACTGGGTCTACAACGTGCTGGAGCGGCCC	KCNQ4_p.Y88C
TTTGTGTCTCATCTACATCACGT	TTTTaCCGCCTCTGGAGCG	CTGAGTTTTACCGCCTCTGGAGCGTGGACC	TAB1_p.Y488C
TTTGGTCGCATCGTCATCTCGCG	TTTTaCCGCCTCTGGAGCG	CTGAGTTTTACCGCCTCTGGAGCGTGGACC	TAB1_p.Y488C
TTTGTCGTCACTATCTATCGCTC	CTACaAGTACCAGCCCAGG	CCGGACTACAAGTACCAGCCCAGGCGGCGG	SOX10_p.K172E
TTTGTAGTATCTACAGTCACGTA	CAACaACTGCAGCACATGC	CGTGGCAACAACTGCAGCACATGCCGGCAC	CABIN1_p.Q1562R
TTTGTAGATCGTCACTATATCAG	CAACaACTGCAGCACATGC	CGTGGCAACAACTGCAGCACATGCCGGCAC	CABIN1_p.Q1562R
TTTGCGTCATCATCGCATATCGC	GGCTCaGCGAGCACTGAGC	CCCATGGCTCAGCGAGCACTGAGCTGGCCC	PRSS8_p.S341G
TTTGACTCATCACAGCATACTAG	GGCTCaGCGAGCACTGAGC	CCCATGGCTCAGCGAGCACTGAGCTGGCCC	PRSS8_p.S341G
TTTGGTCATAGCAGTAGTCTATC	CCCaGGCCCCACTCGGCTT	TGCCCCCCAGGCCCCACTCGGCTTCGGCTG	PLCH2_p.R1183G
TTTGCATGTGTCGCATCTAGTAG	CCCaGGCCCCACTCGGCTT	TGCCCCCCAGGCCCCACTCGGCTTCGGCTG	PLCH2_p.R1183G
TTTGTGAGTCATATATCGTCTAC	CTGCaACCCCTGCTGCACA	CCGCCCTGCAACCCCTGCTGCACACGGTGA	IL17RD_p.Q500R
TTTGCATCTCAGAGCATCGTCTA	CCCaTCGCCATCCTCATCA	GGGTGCCCATCGCCATCCTCATCATGGTGC	SLC4A2_p.I942V
TTTGCTATCATCACACTACGAGT	CCCaTCGCCATCCTCATCA	GGGTGCCCATCGCCATCCTCATCATGGTGC	SLC4A2_p.I942V
TTTGGCAGTATCAGTCTCTAGTA	AGATaCAACCTTGCCATCG	GCGCCAGATACAACCTTGCCATCGAGGAGC	CTSZ_p.Y288C
TTTGACATCACTATATCATCGAT	CGACaTCTGGGTGCGCAGC	GACCCCGACATCTGGGTGCGCAGCCGGCCC	ARHGEF10L_p.I1219V
TTTGGCATCGCTATCATCATCTA	CGACaTCTGGGTGCGCAGC	GACCCCGACATCTGGGTGCGCAGCCGGCCC	ARHGEF10L_p.I1219V
TTTGACTGTATCAGCACGTATCA	AAAGCaCAGTGGGCAACAC	TCAGCAAAGCACAGTGGGCAACACGGGAGC	PIK3CG_p.T895A
TTTGAGTCAGAGCAGTAGTAGTA	CCAaCCCTGCGGAGTGGAC	CGGCGCCAACCCTGCGGAGTGGACGGGCAG	TGM5_p.N251S
TTTGTAGTATCAGATCTAGCAGT	GACCaCACACCCGGCATGG	CCTACGACCACACACCCGGCATGGCGGGCT	IRX5_p.H89R
TTTGATGTGTGTATCAGCACGAC	GAGaCCAGGTCCTTGTCGC	GGTTGGAGACCAGGTCCTTGTCGCGGGCCA	CLIP3_p.D420G
TTTGTACAGAGCAGTAGTCATAT	ACAaCCGGACCGTGCAGCA	CATGAACAACCGGACCGTGCAGCATGGCGT	CX3CR1_p.N140S
TTTGCGATCAGTATCAGCAGTCT	ATGaCCAACGCCCTTCGCA	GAACGATGACCAACGCCCTTCGCAAGGCCC	PSMD3_p.T310A
TTTGTCTATCATCTACGTATCTC	CGCaTCGGCTCCGGGCTCA	CGCCGCGCATCGGCTCCGGGCTCAAGGCGC	C2ORF54_p.I239V
TTTGCTACGTATCTATCATCATC	GCAGCaGCTCGGGCCCCAA	GGGCAGCAGCAGCTCGGGCCCCAAGGGGAA	DCLK2_p.S36G
TTTGCACTCATCTATCTACGAGA	AGaCCGTTGCCTTGGCACT	CTGGGAGACCGTTGCCTTGGCACTTGGCGT	TRMT12_p.T163A
TTTGCAGATCATCAGCTAGTATA	TCCaCTGCGTCCTGGGCCC	GCTCTTCCACTGCGTCCTGGGCCCTGGTGG	ITPRIPL2_p.H453R
TTTGTGTATCTATCTAGTAGCAG	GGACaGTATGCCACGCTGC	AGATGGGACAGTATGCCACGCTGCTGGCTC	FUT1_p.Q95R
TTTGTCATCTACATCTCATACGA	GGACaGTATGCCACGCTGC	AGATGGGACAGTATGCCACGCTGCTGGCTC	FUT1_p.Q95R
TTTGATGTGTGTCATCGCATCAT	CCCCAaCTTCCGCGCGTCC	TACTTCCCCAACTTCCGCGCGTCCGGGGCG	HOXC12_p.N28S
TTTGCTACAGTCAGTATGTATCA	GCCaGTGGCGCTCTGGACG	CGCACGCCAGTGGCGCTCTGGACGAGGGCA	GLI2_p.S1075G
TTTGTCATCATCTCATCGATCTA	GTGATaTGACCACCGACGG	GTACTGTGATATGACCACCGACGGGGGCGG	TNR_p.M1170V
TTTGATATCAGAGTCTCATAGTC	GCCaGCACGCCAGCCCAGA	GCCCAGCCAGCACGCCAGCCCAGACGGCGG	NR2F2_p.S50G
TTTGTACATCTACATCATACGTA	GACTaCAGCACCTGCGTCC	GCTTCGACTACAGCACCTGCGTCCTGGCCA	TRIM50_p.Y334C
TTTGATAGTATCATCGCATCACG	GACTaCAGCACCTGCGTCC	GCTTCGACTACAGCACCTGCGTCCTGGCCA	TRIM50_p.Y334C
TTTGTAGTATCAGTACGTATCTC	CCCaGCATTGACCTGCTGC	GCGAGCCCAGCATTGACCTGCTGCAGGCCT	FAM160B2_p.S19G
TTTGGTACATACTCATCGTCATA	CTTCTaCTGCGAGCGCCGC	CGCGCCTTCTACTGCGAGCGCCGCCGGCCC	CARD11_p.Y970C
TTTGCAGTATCACGTCACGTCTA	CTCaTCGCTGCCGGTGCAG	GTTTCCTCATCGCTGCCGGTGCAGTGGCCC	SLCO2B1_p.I282V
TTTGAGTCATCACTAGTATATAT	CAGGaGCGCCTCTACCCGC	CCGGCCAGGAGCGCCTCTACCCGCCGGGCG	ALKBH5_p.E153G
TTTGGTGTATCATCTGTCAGTAG	TACTaCGTCTGGGGCAGCG	ACATGTACTACGTCTGGGGCAGCGGGGTAC	ABCB9_p.Y412C
TTTGTCTACTATGTATCGTCACA	ACTCCaCCTACGACCGGGC	CATGCACTCCACCTACGACCGGGCCGGCGC	PIAS4_p.T89A
TTTGAGTCACTATCATGTCACTA	CCCaAGCGCATTCACTCCA	AGGCTCCCAAGCGCATTCACTCCATGGCCA	HS3ST4_p.K272E
TTTGCGCATCTCATAGTATCTAT	CCCaAGCGCATTCACTCCA	AGGCTCCCAAGCGCATTCACTCCATGGCCA	HS3ST4_p.K272E
TTTGTCATATGTATATCATCTAT	AGCTCaCAGCTGCCTGCCT	CCCGGAGCTCACAGCTGCCTGCCTGGGCCG	ACTL7B_p.T319A
TTTGTAGCATATCTATCATCGTC	AAGTaTGACCCAGGTGCTT	TGGACAAGTATGACCCAGGTGCTTTGGTCA	OLA1_p.Y254C
TTTGATGTATCTACATATATATA	TTCGaCAGGCTGCTCCACC	CCTGCTTCGACAGGCTGCTCCACCCGGACG	IL17RC_p.D706G
TTTGTCGAGTAGTCATCGTCATA	CTaCCCTGGAGGCCTGTGC	AGATGCTACCCTGGAGGCCTGTGCTGGTGC	PKP1_p.T543A
TTTGACTCAGTACAGCATCGAGA	TCCaCTGCGCCAGGACCTA	AGCGTTCCACTGCGCCAGGACCTATGGCAA	ZNF278_p.H540R
TTTGTATGTATATCAGAGTCTAT	CCTCCaAGTCGTCCTGCGC	CCTGGCCTCCAAGTCGTCCTGCGCCGGCCT	BRAT1_p.K358E
TTTGTCTCATCGACATCGTCACT	CCCaACCTGCAGGTGAGCT	CCAGCCCCAACCTGCAGGTGAGCTCGGACG	PCDHGC5_p.N748D
TTTGAGTGTCACTATCATCACGC	CCGCaTGGCCATTGTCCTG	GGCACCCGCATGGCCATTGTCCTGCGGTTC	UTP20_p.M1038V
TTTGGTCTCATATATATCAGAGC	CCGCaTGGCCATTGTCCTG	GGCACCCGCATGGCCATTGTCCTGCGGTTC	UTP20_p.M1038V
TTTGTGACATCACTAGTATAGTA	GTGGaAGCAGTGCGCGCAG	GAGCCGTGGAAGCAGTGCGCGCAGTGGCTC	VAV3_p.K5E
TTTGCTGCAGTCTAGTAGTATAG	CCTaCACATGTGGAGAATG	GAAACCCTACACATGTGGAGAATGTGGCAA	ZNF721_p.Y635C
TTTGTCAGATATGTATAGTATCT	GCCATaGTAGCAGGTAATG	GCTGCGCCATAGTAGCAGGTAATGAGGAGA	PCDH18_p.I620M
TTTGACACATATCATCTAGAGAG	GGCCaCCAGTGCCAGCCGT	AGTCAGGCCACCAGTGCCAGCCGTGGGCCC	ROR2_p.H335R
TTTGCGTCAGCATCGCTATCATC	GGGCTaCACGACAGGGCCT	TCAGGGGGCTACACGACAGGGCCTGGGCCC	GCAT_p.Y274C
TTTGCATATGTCATCATCGATAT	GGGAaGATCATGTACGTCG	ACCAGGGGAAGATCATGTACGTCGGGGACG	DNMT3A_p.K491R
TTTGCTACAGTCTATCATACGAG	GGGAaGATCATGTACGTCG	ACCAGGGGAAGATCATGTACGTCGGGGACG	DNMT3A_p.K491R
TTTGGTATATATCGTCAGCTATC	GGGAaGATCATGTACGTCG	ACCAGGGGAAGATCATGTACGTCGGGGACG	DNMT3A_p.K491R
TTTGTATATCAGTAGTCTCATAG	GGGAaGATCATGTACGTCG	ACCAGGGGAAGATCATGTACGTCGGGGACG	DNMT3A_p.K491R
TTTGATATCACTACAGAGCTATC	CTCTaTGCTGGTCAGTCCG	GGCTGCTCTATGCTGGTCAGTCCGGGGACC	ETHE1_p.Y74C
TTTGGTGTGTCATCTAGTACATC	AGTaGTGGCACGGATCTGA	GTAGCAGTAGTGGCACGGATCTGACGGGTG	SPAG9_p.S1230G
TTTGGATCACAGAGTAGCATATC	ACGTCaCTTCATCCAGCGC	GTGGCACGTCACTTCATCCAGCGCTGGAAC	PLD1_p.H696R
TTTGTATCAGTCAGTATCATATA	AATCaGAGGAGGAGAACAC	CACCCAATCAGAGGAGGAGAACACTGGAGA	COL12A1_p.Q774R
TTTGGTATCATCACATATCGCTA	AATCaGAGGAGGAGAACAC	CACCCAATCAGAGGAGGAGAACACTGGAGA	COL12A1_p.Q774R
TTTGCTGTGTAGTCATCGCAGTA	CAGTGaGGTGCTGGCTCGG	GGCATCAGTGAGGTGCTGGCTCGGAGGCAC	MFN2_p.E90G
TTTGCAGTCATCATACAGTCTAT	TACCaCGGCGGCCACTCCT	CGGCCTACCACGGCGGCCACTCCTCGGGCA	ARHGEF17_p.H270R
TTTGGATAGTCAGTATATATAGT	GATCCaGTAAGCTCAGCCC	CCGAAGATCCAGTAAGCTCAGCCCTGGGCA	C20ORF152_p.Q383R
TTTGCAGTATCGTATCTCATATA	ATCCaCGATCCCGAGAAGG	CCTACATCCACGATCCCGAGAAGGTGGCCG	ZC3H3_p.H692R
TTTGATATCACAGTACTATCACG	CCTCaTCAAAGGTCTGCGG	AGTGGCCTCATCAAAGGTCTGCGGAGGGAC	SLC12A5_p.I354V
TTTGCTATCATCGCTCATCTATC	GACaTGCCGGAGCCTTCGC	CGTCCGACATGCCGGAGCCTTCGCTGGATG	ZMIZ1_p.M1026V
TTTGTATCTATCATCAGCGAGTA	CGCaAGGCCGCCGTCGCGC	CGGCGCGCAAGGCCGCCGTCGCGCCGGGGC	MAGI2_p.K1426E
TTTGAGTCTCGACATCTAGCATC	ACTaGAGTGCGGCGGTCTT	CACTTACTAGAGTGCGGCGGTCTTCGGGAG	FOXP1_p.L27L
TTTGATGTGTATCATCTACGATA	CTCaTGCAGCTCCAGAGTG	CAGACCTCATGCAGCTCCAGAGTGAGGTAG	MYH3_p.M1736V
TTTGGTATCATACTCATCGCTCG	GGACaTCAGCATCATCGTG	GGCGCGGACATCAGCATCATCGTGCGGGAC	VPS4A_p.I334V
TTTGGTATCTATCATCACTACGA	CGGaGAGGCCGCAGTGCGA	CAGAGCGGAGAGGCCGCAGTGCGACGGGCA	BZRAP1_p.R1563G
TTTGCAGCATCATCATCGCTCGC	GCaGCCTGTCCGTCCGGCT	GGCCAGCAGCCTGTCCGTCCGGCTCGGCCC	MCF2L_p.S1078G
TTTGAGTACAGTATCGCATAGCG	TTCaTGCAGTTCCGCGCCA	TGCGCTTCATGCAGTTCCGCGCCAAGGACA	KCNT1_p.M911V
TTTGTGTGTGTCGCATCTACATC	GCCAAaGGCATCAGCGCGT	GCCAAGCCAAAGGCATCAGCGCGTCGGGAG	SPEG_p.K1639R
TTTGAGTGTATCATCGCTATCAC	AGGGaCCGACGTCATGGTT	TTGCCAGGGACCGACGTCATGGTTCGGTGC	GTF3C1_p.T326A
TTTGGTCAGTATCAGTATAGTAG	TCCaGGGGCCCTTGCACAC	TGTCATCCAGGGGCCCTTGCACACTGGAGA	C20ORF74_p.R166G
TTTGTGTCACTACAGAGTATCGT	ATGATaGGCTGCTCGTTCG	CAGCCATGATAGGCTGCTCGTTCGTGGTCA	WBSCR17_p.I326M
TTTGAGCATAGTATATCATCTCG	GCCaGCCCTGCGCCCTTAG	CGATGGCCAGCCCTGCGCCCTTAGTGGCCT	DLEU7_p.S3G
TTTGGTCATCTCATCGCATAGTA	CCGCaCATCCTGCTCCACA	GCTGCCCGCACATCCTGCTCCACAGGGCAG	CELSR3_p.T2707A
TTTGATGAGTCATCGTATCGCAG	ACaTGAGCCTGGGTGAGCT	GCTGCACATGAGCCTGGGTGAGCTCGGCGA	CNTNAP1_p.M236V
TTTGATGTGTATATCTATAGCTC	ATaCCTGTCAGCCACACGC	CAAGTATACCTGTCAGCCACACGCTGGTGG	MUC17_p.I2284M
TTTGACACAGTAGCTATCTATCA	ATaCCTGTCAGCCACACGC	CAAGTATACCTGTCAGCCACACGCTGGTGG	MUC17_p.I2284M
TTTGGAGAGAGCATCTATCTAGC	GTGCCaAGGGCCAGGTCGC	TCCCAGTGCCAAGGGCCAGGTCGCTGGCCC	FAM193B_p.K344E
TTTGGACATCTACGTATCTATCA	GTGCCaAGGGCCAGGTCGC	TCCCAGTGCCAAGGGCCAGGTCGCTGGCCC	FAM193B_p.K344E
TTTGCGACAGTATCATCATCGCT	GCGGaGGTGGAGCGCTGCC	ACGCCGCGGAGGTGGAGCGCTGCCTGGCGC	ANKRD20A1_p.E48G
TTTGCATCTAGAGCATATCTATC	TCCTaCTCCACCAGCAGCA	AGGACTCCTACTCCACCAGCAGCACGGAGG	RIN3_p.Y550C
TTTGATATATCATATATAGTCTA	CGGCCaGCCAGGTGCCGAT	CCCGCCGGCCAGCCAGGTGCCGATGGGGAG	BSN_p.Q3887R
TTTGGCATAGTATATCATCATCG	GCCAaGTCCAGGGGCGTGG	CCTAGGCCAAGTCCAGGGGCGTGGAGGCCG	GPI_p.K73R
TTTGAGCATGTCATCTACTATCA	GCCAaGTCCAGGGGCGTGG	CCTAGGCCAAGTCCAGGGGCGTGGAGGCCG	GPI_p.K73R
TTTGCTCACAGATCACTATAGCA	ACAGaAAGTATTGCAGTCC	AACGGACAGAAAGTATTGCAGTCCAGGCTG	SYNE1_p.E1390G
TTTGGCATCTAGTCATCTATCAG	CCACCaGCATGCACACGGT	CACAACCACCAGCATGCACACGGTGGGACC	FOXP1_p.S428G
TTTGTCATCAGAGAGTATATAGT	GGaGCGCGCGGTAGAGCCT	GCGATGGAGCGCGCGGTAGAGCCTTGGGGC	ZNF48_p.E2G
TTTGTGAGAGAGCATCTAGTCAG	AAGTaCCCCATCCTGTGCC	GCACCAAGTACCCCATCCTGTGCCAGGCGG	GPR123_p.Y799C
TTTGGATCATCACTATCTAGATC	CGCaCCAACCTCAAGGCCG	TGAGCCGCACCAACCTCAAGGCCGAGGCCG	CHDH_p.T252A
TTTGATCATATATCTATCATATA	GCGGaGTAAGTGTGGGCCC	CATCTGCGGAGTAAGTGTGGGCCCTGGCCC	SMTN_p.E868G
TTTGAGACTCAGCATCTAGCTAT	GCGGaGTAAGTGTGGGCCC	CATCTGCGGAGTAAGTGTGGGCCCTGGCCC	SMTN_p.E868G
TTTGATATCAGATCATATCATCT	TTCGaCCTCAAGACCATGC	TGGTGTTCGACCTCAAGACCATGCGGGAGG	FBXW5_p.D449G
TTTGGTCATCGCAGTATCTAGTA	CTCAaGAGCAACCACGAGC	TCTCCCTCAAGAGCAACCACGAGCAGGTGT	KRT38_p.K239R
TTTGCTATGTGTCGTCATCATCG	CGCCaCGACATCGTGGCCC	TCGCGCGCCACGACATCGTGGCCCTGGGTC	RNF207_p.H140R
TTTGTAGCATAGTATATATCATC	TTCCaGGCCGAGGAGTCGC	AGGCCTTCCAGGCCGAGGAGTCGCCGGGCG	USP20_p.Q809R
TTTGCTCATCGCATCTCTATCGC	AACTGaCGCCTGTCGCTTA	CCTGAAACTGACGCCTGTCGCTTATGGTGA	PFKFB3_p.T421A
TTTGCATAGCATCATGTCATCAG	CAGGTaAGCGCGGCCCCGG	CAGCCCAGGTAAGCGCGGCCCCGGCGGGCT	SYT7_p.001
TTTGGTGTGTATCTATCATCGCG	TGCCGaCAGCCACGCGGAT	GCTCTTGCCGACAGCCACGCGGATGGGCAG	RHBDL3_p.D83G
TTTGTCACATATAGTCATCTATG	TTCCaCACTGTCCCCTACA	GGAATTTCCACACTGTCCCCTACATGGTCG	CES1_p.H343R
TTTGGCACTGTATCAGCATATCT	CTACCaCGTGCTGACCCTG	GGGGGCTACCACGTGCTGACCCTGCGGCAG	OBSCN_p.H3061R
TTTGACACTCACGTCATCAGCTA	GCCGaGCGCCGCGGAGCGC	CGCGAGCCGAGCGCCGCGGAGCGCAGGACC	SOBP_p.S683G
TTTGACAGTGTACATCATCTATC	GCCGaGCGCCGCGGAGCGC	CGCGAGCCGAGCGCCGCGGAGCGCAGGACC	SOBP_p.S683G
TTTGATGATCAGTATCGAGTCTA	GGGCCaGCACAGTCTCGCC	CAGCCGGGCCAGCACAGTCTCGCCCGGTGG	AHDC1_p.S1061G
TTTGCACTGTATCAGCATCGATC	GCGaCGGCCGCGGCAGCCC	CGGCGGCGACGGCCGCGGCAGCCCTGGCGG	SLC25A16_p.T5A
TTTGACGAGTCATCATCATACGC	GATGaCATGCTGTACATCC	AGAAGGATGACATGCTGTACATCCTGGTTG	ALK_p.D769G
TTTGCTCTCAGTATATCTATACT	GATGaCATGCTGTACATCC	AGAAGGATGACATGCTGTACATCCTGGTTG	ALK_p.D769G
TTTGAGACAGAGTCTATCTACTC	CCCaAGCACCCACTTCGGC	CTCCACCCAAGCACCCACTTCGGCTGGTGT	TBX19_p.Q398R
TTTGTCACTCATCACATAGCATA	TGCGCaCCATGTGGTTCGC	CATCATGCGCACCATGTGGTTCGCCGGCGG	LPCAT1_p.T105A
TTTGACACTAGAGCATCATATAG	TCaGTTCACACAGGTCCAG	GCCCATCAGTTCACACAGGTCCAGCGGGAC	CD38_p.Q134R
TTTGAGAGTCGCATCATACGTAT	TGCaGGTACACGGGCCGCG	AGCTCTGCAGGTACACGGGCCGCGTGGTCG	SURF4_p.Q104R
TTTGGCAGACATCATCATCGTGC	GGCaTCCTCCCCTGCGGCT	CTGTGGGCATCCTCCCCTGCGGCTCGGGCA	SPHK2_p.I237V
TTTGGACAGTATCGTGTATCATC	GCCaTCGTGCAGCCCAGCG	CACCAGCCATCGTGCAGCCCAGCGTGGTGA	RBM38_p.I150V
TTTGCGCATACGTATCTATCATC	GCCaTCGTGCAGCCCAGCG	CACCAGCCATCGTGCAGCCCAGCGTGGTGA	RBM38_p.I150V
TTTGTGATCGTCTATATCAGCTC	GTaCCAGGCCCTACGGCTG	GCGCCGTACCAGGCCCTACGGCTGTGGGCC	SOAT2_p.Y182C
TTTGTGTATCTACAGTATAGTAT	GCCACaCGTCCCGGAGCAC	GCGCTGCCACACGTCCCGGAGCACAGGCGC	HEATR1_p.H1389R
TTTGGAGAGAGTAGCATCTATCT	CGGCCaCTGGCCTGCCCTC	GCCCACGGCCACTGGCCTGCCCTCGGGCGC	MTSS1L_p.T551A
TTTGTGTGTCAGAGAGTATATAG	TGCaGGTAACCGCAGGCTG	GCAGCTGCAGGTAACCGCAGGCTGTGGGAG	RGS12_p.Q151R
TTTGCATAGTCAGTATAGCATCT	ATTTGaAAGATTCAGCGGA	CATGAATTTGAAAGATTCAGCGGATGGCCT	PGBD4_p.K302E
TTTGGCATCATGTCAGTAGTCAG	TGCaCGGTCAGTTGCCCTG	TGACTTGCACGGTCAGTTGCCCTGAGGGGC	TP53_p.T125A
TTTGCTATGTCACTATCATATAG	TGCaCGGTCAGTTGCCCTG	TGACTTGCACGGTCAGTTGCCCTGAGGGGC	TP53_p.T125A
TTTGTAGTGTGTCAGCATCTATC	TGCaCGGTCAGTTGCCCTG	TGACTTGCACGGTCAGTTGCCCTGAGGGGC	TP53_p.T125A
TTTGTCTCACTACATCATACGAC	TGCaCGGTCAGTTGCCCTG	TGACTTGCACGGTCAGTTGCCCTGAGGGGC	TP53_p.T125A
TTTGCTCGTCACTCATCGTCACT	GCTGaTGTTCATCTGCTCC	CTGGCGCTGATGTTCATCTGCTCCTGGTAC	SLC12A7_p.M630V
TTTGTCATGTATATCACTATCAT	CCAaCCAGCTTGAGGCCAC	GCTCGCCAACCAGCTTGAGGCCACTGGCGT	DHRS13_p.N213S
TTTGGTCACTCATCACTAGCGTG	ATGCaCCTGCAGATGCGGG	ACCCCATGCACCTGCAGATGCGGGAGGACA	LEPREL2_p.H186R
TTTGCGTCTATATCATCGCTATC	CCCAaCCAGAGGCTGCCCA	CCAACCCCAACCAGAGGCTGCCCAAGGTGG	MYF6_p.N125S
TTTGCACTAGCATATCTATCTAG	CAaCCTGCGGGCCCTGCTG	TACGTCAACCTGCGGGCCCTGCTGCGGCTG	LFNG_p.N135S
TTTGCATGTCGTCATCATCTCGA	CTCCAaCCCAGCCCAATCC	AATGCCTCCAACCCAGCCCAATCCAGGCCA	NR2F1_p.T164A
TTTGCTCAGTCTCGTCTATCGCT	GAGaGCTCTGCCATCATCC	TCCCCGAGAGCTCTGCCATCATCCCGGTGT	GRHL2_p.S146G
TTTGCATCATCACATACATACGT	GCCTCaGGTGCGCGGCGCA	CGACTGCCTCAGGTGCGCGGCGCAGGGAGC	COIL_p.R82G
TTTGTAGTATCGCATACTCTAGC	GCCTCaGGTGCGCGGCGCA	CGACTGCCTCAGGTGCGCGGCGCAGGGAGC	COIL_p.R82G
TTTGGTCACTCATAGCTATCTAG	TTCaGCTGCCCCGGCGTGC	TCGGCTTCAGCTGCCCCGGCGTGCAGGACT	OBSL1_p.S698G
TTTGAGAGTATATCAGTCACTAT	TGAGCaCCCATGAGTGTGC	CACGCTGAGCACCCATGAGTGTGCCGGCCT	PCBD1_p.T79A
TTTGGATATGTCATCATATCATA	ACCGCaGCCTCCTGGGCCT	TGAGGACCGCAGCCTCCTGGGCCTGGGCCT	ARAP1_p.S1043G
TTTGAGTCAGTATATATCACTAC	TTCGaCTATGGCTACAACC	TCCGCTTCGACTATGGCTACAACCTGGTGG	PGAP3_p.D220G
TTTGGTCAGTGTATCATCTATGT	GGTCaCCGCTATGATGTGT	GCTGTGGTCACCGCTATGATGTGTAGGAGG	HLA-C_p.T329A
TTTGTGTGTATCAGATCGCATAT	GGTCaCCGCTATGATGTGT	GCTGTGGTCACCGCTATGATGTGTAGGAGG	HLA-C_p.T329A
TTTGAGCGTGTATCATCTAGCAG	TTGaCCATACATGTAACCA	TGTAGTTGACCATACATGTAACCAAGGTGC	ANKRD50_p.D1039G
TTTGGTCATATATCACTACTATA	CACGGaGCCCGACCCGCTC	GAGGCCACGGAGCCCGACCCGCTCCGGGCG	CPZ_p.E615G
TTTGTGCATCTACATATATCGTG	CACGGaGCCCGACCCGCTC	GAGGCCACGGAGCCCGACCCGCTCCGGGCG	CPZ_p.E615G
TTTGTCTATGTACATCATCGAGC	CTCaGTGGCAAGGCTGCCC	CGGGCCTCAGTGGCAAGGCTGCCCTGGGGC	PAPLN_p.Q622R
TTTGTCAGTCTATCTACTCTACG	TCATaCCACGCCGACGAGG	CCGTGTCATACCACGCCGACGAGGAGGCTG	BRF1_p.Y543C
TTTGCTAGTCATGTATATCACTA	ACGAGaTCATCCTGACGCT	GACCTACGAGATCATCCTGACGCTGGGGCA	ANKS1A_p.I1050V
TTTGTGTATGTATCATCATCTCG	GCTCaCCACCTGGTCCTCA	AGGCTGCTCACCACCTGGTCCTCACGGCCT	PCDHGA8_p.H208R
TTTGTCATCAGACAGTATATCTC	CAGaTTTTGCGCCAGAACC	CTCGCCAGATTTTGCGCCAGAACCGGGGCC	RPS19BP1_p.I94V
TTTGAGTCATCGAGTATAGCATA	GAGCaGGGCGGCACCAAGC	ACCTGGAGCAGGGCGGCACCAAGCTGGTGA	SHH_p.Q209R
TTTGCGTATCTATCACTAGCAGA	CCCaTCGCCACCTACTCCG	CCGTGCCCATCGCCACCTACTCCGTGGTGC	GPR153_p.I61V
TTTGGACTCATCACTACGAGAGT	ACGaCGCCGCCTACCTGGC	GCGCGACGACGCCGCCTACCTGGCGGGCCT	GAL3ST3_p.D220G
TTTGTGCATATCATCATCGCACA	CGCCAaCGGGCACACCAAG	CTCATCGCCAACGGGCACACCAAGTGGCTG	SLC12A3_p.N694S
TTTGTGTCTCATCGTCTAGTAGT	GCTGaCAATCACACGGAGC	TTACGGCTGACAATCACACGGAGCCGGCAG	IHH_p.D281G
TTTGCTAGTAGTCAGTCACTAGT	GCCCCaTGGGCTGCTACCC	CGCGGGCCCCATGGGCTGCTACCCGGGAGG	NFKB2_p.M395V
TTTGTGTAGTCAGTCTATCTATA	GCCCCaTGGGCTGCTACCC	CGCGGGCCCCATGGGCTGCTACCCGGGAGG	NFKB2_p.M395V
TTTGGTGATCATCATCACTACGT	GCCCCaTGGGCTGCTACCC	CGCGGGCCCCATGGGCTGCTACCCGGGAGG	NFKB2_p.M395V
TTTGGCACATATCATCAGCAGTA	GCCCCaTGGGCTGCTACCC	CGCGGGCCCCATGGGCTGCTACCCGGGAGG	NFKB2_p.M395V
TTTGTCTAGTATCTAGTACAGCA	AGGaCGATGGCCGTGGCCG	TGAAGAGGACGATGGCCGTGGCCGGGGCCT	FAM116A_p.D45G
TTTGGCACTATCTATCATCGTGA	AGGaCGATGGCCGTGGCCG	TGAAGAGGACGATGGCCGTGGCCGGGGCCT	FAM116A_p.D45G
TTTGTCATGTGTAGTATATCAGC	ATCGaCTTTCCAGACCTGG	TCTTCATCGACTTTCCAGACCTGGTGGAGC	FAM46B_p.D312G
TTTGGTATCAGATCTACGTATCG	TCATGaTGCTTGGTGTTCG	CCTGCTCATGATGCTTGGTGTTCGTGGCCT	C10ORF35_p.M100V
TTTGGAGCATCTAGTATCTACAT	GTAaCaGTTCCTGCATGGG	CATGTGTAACAGTTCCTGCATGGGCGGCAT	TP53_p.N146S
TTTGGTACATCATCACTAGATCA	GTAaCaGTTCCTGCATGGG	CATGTGTAACAGTTCCTGCATGGGCGGCAT	TP53_p.N146S
TTTGAGATCGTCTATATCATACG	GTGCaGATGCACGATGTGC	CAGCTGTGCAGATGCACGATGTGCTGGTGA	TRRAP_p.Q3118R
TTTGGAGCATCTATCTACGAGTC	GTGCaCGTCACCCGCAGGC	TCACCGTGCACGTCACCCGCAGGCCGGTCC	KCNK1_p.H159R
TTTGTCATACAGTATCATACGTC	GCCaTCTCAGAATCCACAC	GGACCGCCATCTCAGAATCCACACGGGTAG	ZFP64_p.H320R
TTTGATCTCATGTATCGTCTATA	ACCGaCGGCATCCGCGGCA	AGAGCACCGACGGCATCCGCGGCAAGGTGG	SPSB4_p.D85G
TTTGGTCAGAGTCATCGTAGCAT	CGCCAaGTCCTCCCATGTC	GAAACCGCCAAGTCCTCCCATGTCAGGCCG	ABI1_p.S183G
TTTGATCGACATCGTCTATCGCA	CCAaCCCCTGTGAACACGG	CCAGCCCAACCCCTGTGAACACGGTGGGGA	HABP2_p.N80S
TTTGGTCAGTGTATCGTGTATCA	CGCTaCCCACGGCCAGCCT	GGTACCGCTACCCACGGCCAGCCTCGGTGC	GYS1_p.Y636C
TTTGCATAGCATCATCATCACGT	GCGGCaAGGTCGCCTCTAC	GGCCTGCGGCAAGGTCGCCTCTACCGGCAG	KLHDC8A_p.Q232R
TTTGCTCATGTGTCATCGTAGCA	GTGGGaGCCACCTGCGCTG	CTGGAGTGGGAGCCACCTGCGCTGGGGCCA	RYR1_p.S271G
TTTGTCGTAGCATATCTATCTAT	GCCaTGCGCACCCTGGTGA	CGGCCGCCATGCGCACCCTGGTGAAGGAGC	TUBGCP2_p.M296V
TTTGTACTCAGAGTCGCATATAG	GCTaCAACCTCAGCCAGGG	GGCGCGCTACAACCTCAGCCAGGGCGGCTA	KCNK3_p.Y52C
TTTGGCAGTATCAGCAGTCTAGA	GTCCaCACACCACTCTCCC	CCGCAGTCCACACACCACTCTCCCAGGACC	MED16_p.T858A
TTTGAGTACAGTATATATCGCAT	TCGGaCCAGGAGCTGGCCG	ACATGTCGGACCAGGAGCTGGCCGAGGTCT	DBNDD1_p.D105G
TTTGAGTATATCTCAGTAGCATA	AAGGaCGCGTGGGCCTCGG	GCTGCAAGGACGCGTGGGCCTCGGAGGGGC	RCCD1_p.D75G
TTTGAGATATCGTCTATCATCGC	ACCCCaGTGGTTCCAGTGC	CCCCGACCCCAGTGGTTCCAGTGCGGGAGG	ASTL_p.S326G
TTTGCAGTAGCATCGTCTAGTAT	GTACaGCCTTGTGCCTGAC	CAGGTGTACAGCCTTGTGCCTGACAGGACC	STK19_p.S177G
TTTGATAGTATATATCATAGCAT	GCCCaCATGCCTGTGCCCA	CCAATGCCCACATGCCTGTGCCCATGGAAA	KIAA0408_p.H500R
TTTGAGTATCATCAGCAGAGTAG	CTaGAACCGCCGCTGGCAC	CCCATCTAGAACCGCCGCTGGCACTGGAGC	REG1A_p.001
TTTGTCATCAGTCTCTATCTATA	GCTaCCAGCCCATCTGCTG	ACCCTGCTACCAGCCCATCTGCTGTGGGTC	KRTAP9L2_p.Y86C
TTTGATATATCGTCTATATCACG	TCACCaTGAAGCCTGGCAC	TCTGGTCACCATGAAGCCTGGCACAGGAAC	NRCAM_p.M91V
TTTGCACGACATCTATCAGCAGC	GCCaCTACATTGACGTGAA	CGATTGCCACTACATTGACGTGAAGGGCAC	PHYH_p.H288R
TTTGACTCATCGTCATCGCACTA	TGGCCaTGGTGCCCCACTA	GGAGCTGGCCATGGTGCCCCACTATGGTGG	GRWD1_p.M145V
TTTGTGTGTCGCAGTATATCTAT	GTaTCAAGACAAGCTGGCC	GCCCAGTATCAAGACAAGCTGGCCCGGCAG	ATAD3B_p.Y132C
TTTGACAGCACTATCTATCTATA	GGGCCaGCAAGCCAGGGTT	ACGCTGGGCCAGCAAGCCAGGGTTTGGTTG	TMC4_p.Q334R
TTTGCAGTCATCATCTATCACTG	GGTCTaCACCTCCCTGCAA	AAGGTGGTCTACACCTCCCTGCAATGGGCC	TSEN34_p.Y301C
TTTGTGTCAGTCTCTATCTACAG	CATGaCGTCACCTGCCCGG	GTGGCCATGACGTCACCTGCCCGGTGGCTA	TUBGCP2_p.D466G
TTTGATACAGCATATATCGTCTA	CATGaCGTCACCTGCCCGG	GTGGCCATGACGTCACCTGCCCGGTGGCTA	TUBGCP2_p.D466G
TTTGATATATCGTCTATAGTCAT	AACCaGCTCCTCCGTCCCC	GGACCAACCAGCTCCTCCGTCCCCTGGGCA	PIPOX_p.Q208R
TTTGACAGTACATCATCGTATAG	GCCACaTGAACGTGCATCG	CAACCGCCACATGAACGTGCATCGTGGTGT	ZBTB12_p.M378V
TTTGACAGAGCAGTATCTATCGT	GCaGCCACAGCTCCGAAGC	CACCGGCAGCCACAGCTCCGAAGCTGGCAA	SLC9A3R2_p.S130G
TTTGCTGTCTCTCATCTAGCTAT	GCaGCCACAGCTCCGAAGC	CACCGGCAGCCACAGCTCCGAAGCTGGCAA	SLC9A3R2_p.S130G
TTTGATCTGCATCATAGCATATG	TGCaCCAAGCGGCTGTGGC	AGGCGTGCACCAAGCGGCTGTGGCAGGCGG	CACNG6_p.T88A
TTTGTACAGTACAGTAGCATCTG	CCTGCaAGTAAGTCCCCTC	CTTCCCCTGCAAGTAAGTCCCCTCCGGTCT	PLG_p.K317E
TTTGATCAGATCAGCTAGTATCT	TCAACaCTGTCACTGTGCC	TGGTGTCAACACTGTCACTGTGCCCGGCCC	MACROD2_p.T284A
TTTGGATCATCTCAGTGTAGTAT	GCCaCCGAGAAAGCCCGCC	TGAGCGCCACCGAGAAAGCCCGCCGGGAGA	AZI1_p.T684A
TTTGACTGTATCGTCACGTATAT	GCCaGTGCCCCGTGAGGCC	TGCATGCCAGTGCCCCGTGAGGCCAGGCTG	DEPDC5_p.S1501G
TTTGGATCATCACAGTATCTCTA	TGGGCaGTGGCTTGTTCAT	CAATGTGGGCAGTGGCTTGTTCATCGGCCT	SLC5A9_p.S90G
TTTGAGTATCGCACTATCATACA	CGaCTCGGGCCAGAACGCC	GACGGCGACTCGGGCCAGAACGCCTGGCTG	PCDHB7_p.D595G
TTTGGACACAGTATCTATCTCTA	CGaCTCGGGCCAGAACGCC	GACGGCGACTCGGGCCAGAACGCCTGGCTG	PCDHB7_p.D595G
TTTGGCATCACTATCTAGTACAT	AGGGaCTGGCACACTGTCC	ACACAAGGGACTGGCACACTGTCCAGGGAT	FAM123C_p.T592A
TTTGTCATATCAGCATCGAGTAG	AGCTaCATCATCGACGTGC	TGCCCAGCTACATCATCGACGTGCGGGCCC	CPSF1_p.Y189C
TTTGAGTGTCTGTATCATATCGC	AGCTaCATCATCGACGTGC	TGCCCAGCTACATCATCGACGTGCGGGCCC	CPSF1_p.Y189C
TTTGATGTACATCATCATACGCT	AGCaGCAGCTTGGCCACGG	GCAGCAGCAGCAGCTTGGCCACGGCGGCCC	IRF2BP2_p.Q97R
TTTGTCACATCATGTCTATATCT	CCTCaGCAGCATCCTGAGC	GTGGCCCTCAGCAGCATCCTGAGCGGGATC	KCNG4_p.S437G
TTTGTATCAGATCAGTATATCAG	CAGCaTGACAGCACCCTGC	ACCTGCAGCATGACAGCACCCTGCTGGCCC	ACPT_p.H288R
TTTGTGTCACGTCATCATCTCGC	GTCaCTCGGAGTATGGCCT	GCTACGTCACTCGGAGTATGGCCTTGGCCG	SNTB1_p.T252A
TTTGAGATAGTATGTATCGTAGC	GACGCaCAGGTAGGCACAG	TCGGTGACGCACAGGTAGGCACAGCGGGCC	KSR1_p.H348R
TTTGATCACTAGTATATAGTATA	AACaTGCAGCGCTACGACC	TGTCCAACATGCAGCGCTACGACCTGGCCT	C6ORF174_p.M733V
TTTGCATATCGCTCATCTAGCTA	ACAaTTTGGTAGAAGCCTT	AGTGAACAATTTGGTAGAAGCCTTTGGCAA	MYO3A_p.N468S
TTTGCTATCATCGCATCATACTC	TGTaGGAAGCAACTGCTGC	CACGATGTAGGAAGCAACTGCTGCTGGCTG	EPG5_p.R301G
TTTGATCAGTAGTATATATCAGC	CAGGaCGCACCACCTGTCC	GATGACAGGACGCACCACCTGTCCTGGGAG	ARHGDIG_p.T208A
TTTGTGTCGTCTATCATCATCAC	CAGGaCGCACCACCTGTCC	GATGACAGGACGCACCACCTGTCCTGGGAG	ARHGDIG_p.T208A
TTTGATCATCGCATCTAGTATCG	CTAGCaCATACCGCTCCAA	CAGGTCTAGCACATACCGCTCCAAGGGCTT	BACE2_p.T137A
TTTGCTCATCATCGCTATATCAG	GTGaGCCCCCACAGTGGGG	GGAAGGTGAGCCCCCACAGTGGGGTGGTGG	FBLN1_p.S636G
TTTGTCTAGTATATCATCACTAC	CGAAGaCCAGCTGAGGCAG	GCTTCCGAAGACCAGCTGAGGCAGAGGCTG	CCDC153_p.D60G
TTTGGTGATCATCTATAGCATAC	GGCaCCTGCTCACCCACCA	GGACAGGCACCTGCTCACCCACCAGGGACA	ZNF641_p.H395R
TTTGCGCAGTAGTCATCATGTCT	CCCTaGCCGTGGCCGACAT	CCTAGCCCTAGCCGTGGCCGACATGGGTCT	HRNR_p.S1950G
TTTGTATATCATGTGTCGTCAGA	TCaCCTGCTTTGCCAAGGA	CGAGCTCACCTGCTTTGCCAAGGACGGTAG	LHX9_p.T101A
TTTGATCGCAGTCAGTCTAGTAG	TCaCCTGCTTTGCCAAGGA	CGAGCTCACCTGCTTTGCCAAGGACGGTAG	LHX9_p.T101A
TTTGTCATCAGCACATATCTATA	CTaTGTGTGGAAGTGGGTC	CTCTCCTATGTGTGGAAGTGGGTCAGGCTC	TMEM140_p.Y137C
TTTGCTGTCTATGTATCGTCAGA	CCAaCATCGCCGCCATCGT	AGGCCCCAACATCGCCGCCATCGTCGGGGG	ITGB2_p.N700S
TTTGTATGTATCGTGTCTATCTC	CCAaCATCGCCGCCATCGT	AGGCCCCAACATCGCCGCCATCGTCGGGGG	ITGB2_p.N700S
TTTGCATGTATATCACAGAGTCT	GTCTCaTGCTCTCAGCAAC	AGGCAGTCTCATGCTCTCAGCAACTGGGAC	APOL5_p.M168V
TTTGTCAGCACATATCATCATCA	TTCaGTGTGAGCAAGGACG	TCCGCTTCAGTGTGAGCAAGGACGTGGTTG	E4F1_p.S280G
TTTGATAGTATCGTCAGCAGACA	CCGGaTGTGCTGAGCTGCC	ACGCCCCGGATGTGCTGAGCTGCCTGGAGC	TUBGCP6_p.D1597G
TTTGAGTCGCATCGTCATCTCGT	TGCaGATGTCGCTGGACTA	GGCCCTGCAGATGTCGCTGGACTATGGGTT	ITIH1_p.Q595R
TTTGGTCATATAGTCATCTACTA	GGCaCCATCATGGCCAAGA	TGATTGGCACCATCATGGCCAAGATGGCGC	KCNJ4_p.T170A
TTTGCTCAGTATCATCGCTATAC	CCaGTGCTGCCCCGAACTG	ATCGCCCAGTGCTGCCCCGAACTGAGGCGA	FBXL7_p.Q209R
TTTGTGACATCATCGCTCTATGC	AATGaCCTGCCTTCCGATG	GTCCTAATGACCTGCCTTCCGATGCGGCCT	COG1_p.D482G
TTTGTGTCATCACATATCTACGC	CCCaGCCCTGCTGCCCTGT	ACAGTCCCAGCCCTGCTGCCCTGTCGGCCA	PGLYRP4_p.S162G
TTTGCTAGTAGCATCATATATCA	TTCTaTGAGTTCCGTGCCC	GCCACTTCTATGAGTTCCGTGCCCGGGCTG	MYOM3_p.Y770C
TTTGGCATCATCGCATCACTCAC	GCATCaCTGTCCTGGTAAC	CCCTAGCATCACTGTCCTGGTAACTGGGGC	AACS_p.T376A
TTTGTAGTCATCTCATAGCATCA	AGAaCCCCTGTCAGCATGG	CATCCAGAACCCCTGTCAGCATGGAGGCAC	SLIT3_p.N962S
TTTGTGACAGTCAGTCAGTCACG	TCCaTGGTGCACAGCGTGC	CCGTGTCCATGGTGCACAGCGTGCCGGAGT	CTDP1_p.M152V
TTTGTCTCAGCATCTATCGAGCT	CGTaCTGTTCTGGGCATTG	TCCTCCGTACTGTTCTGGGCATTGTGGCCC	OR51T1_p.T226A
TTTGTCGTCACTATATCATATAG	ATATaCACCCGCGAGGAGC	CAGACATATACACCCGCGAGGAGCTGGCGC	PAX7_p.Y245C
TTTGTACATCTCATCGTCATACT	ATATaCACCCGCGAGGAGC	CAGACATATACACCCGCGAGGAGCTGGCGC	PAX7_p.Y245C
TTTGAGCATCATATATCAGAGTA	GCCaTGTCTGCGGCCATGA	TCCCCGCCATGTCTGCGGCCATGAGGGAGA	REEP5_p.M1V
TTTGGAGTGTATCATCGTCTGTA	TCCTGaAGGATAAGGAACT	TACAGTCCTGAAGGATAAGGAACTTGGAAG	OTOA_p.K211E
TTTGTGTGTGTATCGCTCATCTA	CGTCCaCGCCGCTCTTGAC	GGCGCCGTCCACGCCGCTCTTGACAGGTGA	EIF2A_p.T5A
TTTGCTATCAGATCATCATACGA	CGTaCCTTGGGCGACAGGG	CGGCGCGTACCTTGGGCGACAGGGAGGCCG	PCDHGB3_p.T631A
TTTGACATCACTCATCGTCAGAG	TTCaCGACCGAGGGAACAT	GCGGATTCACGACCGAGGGAACATTGGCAA	VAT1L_p.H368R
TTTGACATACATCATCGTAGCGC	GGACCaGCAACCCTCAGCA	GTTCTGGACCAGCAACCCTCAGCACGGCGG	FZD1_p.S249G
TTTGGTCAGTATCATCGCATATC	AATaACATTCTATTGACCA	AAGGCAATAACATTCTATTGACCACGGAAG	MYO3A_p.N155D
TTTGGTATCAGTAGTATATCATC	TCTGTaCACACTGGTGGGA	GCCACTCTGTACACACTGGTGGGAGGGCTC	SLC5A7_p.Y175C
TTTGTCATGTCATCATACGTCAT	CTCaCGCCGTCCCAGTCGC	CGCTGCTCACGCCGTCCCAGTCGCTGGACG	KCTD12_p.T196A
TTTGGTGCATCTCATCGTCAGTC	CCCaGGGCAAGCCCCGCTC	AGCGCCCCAGGGCAAGCCCCGCTCCGGCCA	RASSF3_p.Q29R
TTTGTGTCGCATCGTCATCATAC	CTAaGCCCCATCTGCCCCG	TCCAGCTAAGCCCCATCTGCCCCGAGGAGC	EPAS1_p.S543G
TTTGATCATGATCGTCATCGCAT	GCGCaCCAGGAGCTGGGCA	CAACCGCGCACCAGGAGCTGGGCACGGCGG	ONECUT2_p.H88R
TTTGTATGTGTCAGCAGTACGTA	AGCTCaGCCATGCCAGCTC	TGACAAGCTCAGCCATGCCAGCTCTGGTGC	RAP1GAP2_p.S722G
TTTGGCATCGTCACATATCTATA	ATCTaGACCTAGCCGGGGC	GCTGCATCTAGACCTAGCCGGGGCTGGCGT	ZFP91_p.R147G
TTTGTCACATAGTCTCATCATCT	CCGTGaATGGCTTGTTGAT	TCAGTCCGTGAATGGCTTGTTGATTGGCAC	SOCS6_p.N286D
TTTGTGTATATCATACGTCTAGC	ATCaTGGTACCCATGCAGC	AGCGGATCATGGTACCCATGCAGCAGGCAC	DNMBP_p.M811V
TTTGGTATCGCAGTATATAGCTA	ATGTaCCTCTCCCTTGCCA	CTCAGATGTACCTCTCCCTTGCCATGGGCT	OR13F1_p.Y102C
TTTGCATCGTCAGTATCGCTATA	TGCaAGGCTGGAAGTCCGG	GGGACTGCAAGGCTGGAAGTCCGGTGGGGA	CREB3L4_p.Q48R
TTTGATGTGTATCGCAGTATAGA	GGCaGGGGGTACTGCGCGC	GCGCCGGCAGGGGGTACTGCGCGCCGGGCA	IGFBP7_p.R78G
TTTGCATACATCATGTCATCATG	GGCaGGGGGTACTGCGCGC	GCGCCGGCAGGGGGTACTGCGCGCCGGGCA	IGFBP7_p.R78G
TTTGGTGTAGCACTATCTATCAT	GCCGaCTGCACCTGGCACA	AGCTGGCCGACTGCACCTGGCACATGGCGG	RAMP1_p.D71G
TTTGCATGATCATCGTCATCGCG	GCCGaCTGCACCTGGCACA	AGCTGGCCGACTGCACCTGGCACATGGCGG	RAMP1_p.D71G
TTTGTCATCATATCAGTAGTCAC	GAGaAGCACTCGGGCCGCC	CCCGGGAGAAGCACTCGGGCCGCCAGGTGG	PAK6_p.K427E
TTTGATGTCTATCGTCATCTATA	CACaACGCTGAACCGTGGC	CAGTCCACAACGCTGAACCGTGGCTGGACG	B3GNTL1_p.N28D
TTTGTGTCAGTATCTCTATCGCA	CCCCaCGCCATCCTGCGTC	CCCTCCCCCACGCCATCCTGCGTCTGGACC	ACTG1_p.H173R
TTTGTATACATCATCATATCATC	CCAaTGGTTGTATTCTGCT	GGCAACCAATGGTTGTATTCTGCTTGGGGA	ZCCHC11_p.N744S
TTTGTATCAGTATCATCTACGTG	CAGGaAGAGGAGCAGCGCC	AGCAGCAGGAAGAGGAGCAGCGCCGGGACT	TCHH_p.E760G
TTTGATCATCTCACAGCAGTCTA	CAGGaAGAGGAGCAGCGCC	AGCAGCAGGAAGAGGAGCAGCGCCGGGACT	TCHH_p.E760G
TTTGGTATCATATATCGTCAGAT	TCCGCaTCCCTTGGAAGCA	GCGCTTCCGCATCCCTTGGAAGCACGGCCT	IRF3_p.I36V
TTTGATAGTACAGCATCGTCAGT	CTGGaCCACACGCGGCCCA	CGGTGCTGGACCACACGCGGCCCACGGCGC	KDM4B_p.D343G
TTTGACGCATCGTCATCTGCTAT	CAGaGCAACGAGCAGGGCC	TGGCTCAGAGCAACGAGCAGGGCCAGGTCT	RHBDL1_p.S118G
TTTGTCGTCAGTATATAGCATAC	CAACCaTTCTGCAGATGTC	CAGTGCAACCATTCTGCAGATGTCTGGTGT	SLC2A13_p.I332V
TTTGTATAGTCTATCAGCATCAC	TGCaGCAGTGGCTCAAGCC	CGAGCTGCAGCAGTGGCTCAAGCCAGGCCT	CD14_p.Q165R
TTTGAGTCATCTGTCACGTATCA	CAATaACCTGCGTTGCATG	TATGACAATAACCTGCGTTGCATGTGGATG	CSMD3_p.N1438D
TTTGCACACATATCATCACAGCT	GCGTAaGCTGGAGCGGATG	CGCAGGCGTAAGCTGGAGCGGATGAGGTCT	NPHP4_p.K915R
TTTGTGTCATCATCACTAGCATA	GCGTAaGCTGGAGCGGATG	CGCAGGCGTAAGCTGGAGCGGATGAGGTCT	NPHP4_p.K915R
TTTGTATCAGCAGTCTCTATCGA	GCGGCaCCTGCTACGCGAG	CGCACGCGGCACCTGCTACGCGAGTGGTAC	SIX6_p.H141R
TTTGCTCTAGTATATCAGTACGC	TTaCATAGAATGCGTCATA	GACTGTTACATAGAATGCGTCATAAGGGGT	ZFP42_p.Y72C
TTTGTACATCATCTCAGTAGCGA	TTaCATAGAATGCGTCATA	GACTGTTACATAGAATGCGTCATAAGGGGT	ZFP42_p.Y72C
TTTGAGTCATCTCATCACGATCT	TGCaACGAGTGGCTCACTC	CCGCCTGCAACGAGTGGCTCACTCAGGTGG	B4GALNT2_p.Q493R
TTTGGTGTGCAGTATATCTAGCT	CAGCaGCTGCAGCGAGACC	CCCTGCAGCAGCTGCAGCGAGACCTGGGCC	GPX7_p.Q69R
TTTGACATCATCACGTCATACTC	CGGCaGCCACGGCACCCTG	GGCAGCGGCAGCCACGGCACCCTGGGGCTG	DUSP4_p.S33G
TTTGTCACAGAGATCTAGCATAT	TGCaATTTCTCGGACCGCC	AGCAGTGCAATTTCTCGGACCGCCAGGCCG	DNAI2_p.N19D
TTTGGCACTGTATCGTATATATA	CGCCTaCTCATTGCTGGCC	GCCATCGCCTACTCATTGCTGGCCGGGCTG	SLC26A1_p.Y90C
TTTGGATCTACATCTCAGTATCA	CGCCTaCTCATTGCTGGCC	GCCATCGCCTACTCATTGCTGGCCGGGCTG	SLC26A1_p.Y90C
TTTGATCTAGTCAGTATCGTCAT	CGCCaTCTGGCAACAGGCC	GCCAGCGCCATCTGGCAACAGGCCCGGGAG	PRMT6_p.I116V
TTTGGCAGTATATATCGTCAGCT	CCAaCCAGGAAGTTCCTCC	GGATCCCAACCAGGAAGTTCCTCCTGGGCC	LARP1_p.N732S
TTTGTCATATCATCTCTACGACT	TCCaCAGTGCTGACCACGA	ACACCTCCACAGTGCTGACCACGAAGGCCA	MUC5B_p.T4319A
TTTGATACATATATCATCTCTAG	TCCaCAGTGCTGACCACGA	ACACCTCCACAGTGCTGACCACGAAGGCCA	MUC5B_p.T4319A
TTTGCTATCTATCATCGTCAGAT	CCGCGaTGTTCTGTGTGCA	TTGCCCCGCGATGTTCTGTGTGCAAGGAGC	LPP_p.R535R
TTTGACATACATCATCTATCGAG	TACCaCTGGCTGGGCCGCA	TGTGCTACCACTGGCTGGGCCGCAGGGTGG	TMC6_p.H527R
TTTGCAGTATATCAGTCTATACT	GAGGaCGAGGGCGCGGGCG	CCGACGAGGACGAGGGCGCGGGCGCGGCGG	RYR1_p.D4262G
TTTGACATCATCATACATATCGA	CCGCCaCCGCCGCAGCCAC	CGCCGCCGCCACCGCCGCAGCCACCGGCCC	HOXA2_p.T118A
TTTGCTCATGTCAGTAGTAGTAT	CCGCCaCCGCCGCAGCCAC	CGCCGCCGCCACCGCCGCAGCCACCGGCCC	HOXA2_p.T118A
TTTGGTGTACATGTATATCTATA	GCCaGCCGCGCGGCCTCGG	TAGCGGCCAGCCGCGCGGCCTCGGTGGACG	SGSM2_p.S440G
TTTGGTAGTCATCATAGTCTCAT	ATGTaTGATGGCACCAAGG	ACCTGATGTATGATGGCACCAAGGAGGTGC	IRF6_p.Y97C
TTTGACTCAGATCAGCACTATAT	GCCCaTGGCCAAGCAGCCT	TCCTTGCCCATGGCCAAGCAGCCTGGGCGC	AATK_p.M104V
TTTGTGTCTCAGAGTCTAGTACG	CAGGaCAACCTGATTGTGG	GGCTGCAGGACAACCTGATTGTGGTGGCGG	TSPAN17_p.D233G
TTTGAGTCGCATCTAGTAGTCGC	GGGACaAGAGGCCGGGCCC	CACCTGGGACAAGAGGCCGGGCCCGGGGAC	MSI2_p.T192T
TTTGGATCATCGCATCTCTACAT	GGGACaAGAGGCCGGGCCC	CACCTGGGACAAGAGGCCGGGCCCGGGGAC	MSI2_p.T192T
TTTGTATCGAGTCATCACTAGTA	GGGACaAGAGGCCGGGCCC	CACCTGGGACAAGAGGCCGGGCCCGGGGAC	MSI2_p.T192T
TTTGAGAGCATCGCAGTATCTAG	GGGACaAGAGGCCGGGCCC	CACCTGGGACAAGAGGCCGGGCCCGGGGAC	MSI2_p.T192T
TTTGTCTCATCTCACAGAGATCA	TGCaGTGTGCTGCTCTGGT	CCTCCTGCAGTGTGCTGCTCTGGTTGGTGA	PPARGC1A_p.001
TTTGGTCGTCTATCAGCACTAGT	GGCaCCATGCAGCGCAACC	CGCGGGGCACCATGCAGCGCAACCTGGCCC	B3GAT1_p.T167A
TTTGTGTGTGTCGTCTAGTATCT	GCTCTaGCTGTGGCAAGCG	TTCCTGCTCTAGCTGTGGCAAGCGGGGCTG	KRTAP5-9_p.S56G
TTTGTCAGAGCATCATATATCAG	TCGaCCTCGGCGCTCTGGC	CTACATCGACCTCGGCGCTCTGGCTGGCTA	MAP3K8_p.D447G
TTTGTCATCATCATAGCTATCAG	GGGaCCGCCAGCAGCTCGG	GGCCAGGGACCGCCAGCAGCTCGGGGGGCT	NCOR2_p.T1514A
TTTGTGTCAGTCAGTCAGCTAGC	CCCTaCCACATCCAGAAGT	CCCGGCCCTACCACATCCAGAAGTGGGCCA	ACSBG1_p.Y677C
TTTGGAGTGTCTATATATCATCG	CAAaCTGGTGTCCACCACT	AAGCCCAAACTGGTGTCCACCACTGGGGCA	PTPRD_p.K815K
TTTGATCTATCATCTACGATATA	CAGCaTGGTCCTGGAACTC	CTGTCCAGCATGGTCCTGGAACTCAGGGGC	THBS1_p.M280V
TTTGATATCAGTACAGTATATGT	TGAGCaTTCCCGACTCTCT	GGCACTGAGCATTCCCGACTCTCTGGGCCG	CAMTA2_p.I785V
TTTGAGTCATACTCAGTATATCG	TGAGCaTTCCCGACTCTCT	GGCACTGAGCATTCCCGACTCTCTGGGCCG	CAMTA2_p.I785V
TTTGCATGTCAGTGTATCTATAC	ATCaTGGTGCCTGGCTGCC	CGTTCATCATGGTGCCTGGCTGCCAGGCAG	IL2RA_p.M15V
TTTGGCATCGCATCGTCATCTCG	GTCaGGGCTGCTCTGGGTC	CTGCCGTCAGGGCTGCTCTGGGTCCGGAAG	PKLR_p.R298G
TTTGACATGTCACTCAGCATCTC	ATGGaGATGCCTTTCACCA	ATGGCATGGAGATGCCTTTCACCAAGGAGC	CHKB_p.E178G
TTTGATGTATCAGATCATCGTCA	GAGaGCAGGCGGCGCTGCG	AGAACGAGAGCAGGCGGCGCTGCGCGGACG	NKX3-2_p.S103G
TTTGGCATACTCACGTCATCTCT	GCCCCaCGGCCCTCGCTTC	GTCCAGCCCCACGGCCCTCGCTTCAGGCTG	ABP1_p.H306R
TTTGGTCAGCAGTAGTCTAGCAG	CAGCaCCCCTACAGACGTG	CAAGCCAGCACCCCTACAGACGTGCGGGAT	CCND2_p.T280A
TTTGCTATCTAGTATAGTATATA	TACTaCAGACGTCCGCTGC	ATGACTACTACAGACGTCCGCTGCGGGTAC	CST1_p.Y64C
TTTGAGTCAGTATATCAGCATCG	CGCaGCTGCACCTGCACTG	TGCCACGCAGCTGCACCTGCACTGGGGGAA	CA12_p.Q117R
TTTGCAGAGAGCATCGCAGTAGT	TTCaTGAGCAGCAAGCCAT	GGGCCTTCATGAGCAGCAAGCCATCGGCGC	GRIK3_p.M711V
TTTGTACTAGCATCGTCATCTCG	GTGCaGCGCTCCAAGGTAG	GCACGGTGCAGCGCTCCAAGGTAGGGGCCT	LIMD2_p.Q25R
TTTGGTCATCTATCACTAGCAGC	GTGCaGCGCTCCAAGGTAG	GCACGGTGCAGCGCTCCAAGGTAGGGGCCT	LIMD2_p.Q25R
TTTGACACAGTATCAGTAGTACA	GTaAGCGATACTCCAGATG	CCCCTGTAAGCGATACTCCAGATGAGGGCG	IKZF1_p.V20V
TTTGATATATATCAGTATCTCTA	CGAaTGGACATTGACAATG	AGATCCGAATGGACATTGACAATGTGGAGA	ABCA1_p.M558V
TTTGCTATAGTATATCATCTCGC	CCTaTGGCTGCTCCGAGTG	GCGGCCCTATGGCTGCTCCGAGTGCGGAAA	ZNF837_p.Y447C
TTTGATATCAGCAGTATATCATG	CCTaTGGCTGCTCCGAGTG	GCGGCCCTATGGCTGCTCCGAGTGCGGAAA	ZNF837_p.Y447C
TTTGTCATACATCATCATCTATC	GCGCaGGCCAATGTGTCCA	TGATGGCGCAGGCCAATGTGTCCAGGGCCA	NACAD_p.Q1534R
TTTGTCTCTAGTATCATCTACGC	CTGGaCGGACAAGCAGAAG	CAGGCCTGGACGGACAAGCAGAAGGGGCTG	FAM186B_p.T675A
TTTGTATCAGTCACGAGTATCGC	AGGaTGGTAGCACACAACC	TCTGTAGGATGGTAGCACACAACCAGGTGG	SOCS1_p.M1V
TTTGCTATAGTATCATCTAGCAT	GCTaCCTGCTCTCGGCCCC	TCACTGCTACCTGCTCTCGGCCCCCGGACC	GIMAP1_p.Y105C
TTTGATCAGTGTAGTCTATCTAC	GCTaCCTGCTCTCGGCCCC	TCACTGCTACCTGCTCTCGGCCCCCGGACC	GIMAP1_p.Y105C
TTTGTGATCTATCATAGCACTAC	CTGGaCACGTGTGGGGAAG	CCTCCCTGGACACGTGTGGGGAAGAGGCCT	TRPV4_p.D425G
TTTGCTATATCATCACGTCTACT	GCTGAaCCGCGTGATCCAG	AGCGAGCTGAACCGCGTGATCCAGAGGCTG	KRT2_p.N400S
TTTGTCTCACTATCACGTCATCG	AGCaCGCCGCTCTTCACTG	TGGCCAGCACGCCGCTCTTCACTGTGGTCA	ABCC3_p.T1108A
TTTGCAGTATCTCATACGACATC	CCCaGCTGGTAAGGAACTG	CGACCCCCAGCTGGTAAGGAACTGTGGGCT	KIAA0467_p.Q2423R
TTTGCATGTGTCACTATCACGTA	AGCaTGGCCGTGCTGCCCC	TGGTGAGCATGGCCGTGCTGCCCCTGGCCC	MYO7B_p.M1629V
TTTGATCGTCATCATACATCATC	TGAaGCCCTCAGACCGAGA	TAGGCTGAAGCCCTCAGACCGAGATGGGCC	KIAA0895L_p.K29R
TTTGATATCATGTATAGTATAGT	CTCaCCCTCAGGTCTCCTG	CTGTCCTCACCCTCAGGTCTCCTGGGGCCC	FCRL2_p.T303A
TTTGGCTCATCATCTAGCATCGA	CTGCaTGTGGGAGCAGTGC	TCCAGCTGCATGTGGGAGCAGTGCCGGCCA	CD164L2_p.M76V
TTTGGTCGTCAGTATCACTACTA	CGTGaTCGTAGAGCACGCC	GAGCGCGTGATCGTAGAGCACGCCCGGGGC	SRSF6_p.I66V
TTTGTACACAGTATCTATCTAGC	CGTGaTCGTAGAGCACGCC	GAGCGCGTGATCGTAGAGCACGCCCGGGGC	SRSF6_p.I66V
TTTGTGTCATCACTGTATCATAC	ATCaTCAAGAAGGGGCAGA	GTGTGATCATCAAGAAGGGGCAGAAGGGCA	C20ORF152_p.I144V
TTTGTACATCTGTCAGTATCTAT	CATaCCCATTTGGTGCAGC	ATCCGCATACCCATTTGGTGCAGCAGGCCA	GDF11_p.T356A
TTTGTCGCATATCATCGCATCGT	CATaCCCATTTGGTGCAGC	ATCCGCATACCCATTTGGTGCAGCAGGCCA	GDF11_p.T356A
TTTGATACTCATCTAGTCTACGT	GTACaTCATGCTCAGCGGC	TGCACGTACATCATGCTCAGCGGCCGGCTG	PNPLA7_p.I615V
TTTGAGTACATCATCAGCAGTAG	CCCaGCCGTCACCCTCTGC	GGCTGCCCAGCCGTCACCCTCTGCCGGCTG	SOLH_p.Q264R
TTTGGTGTGTCAGTATCGTATAG	GGaGCTGGACCAGCTGCTG	CTGGCGGAGCTGGACCAGCTGCTGCGGCAG	NOG_p.E103G
TTTGGTATATCAGTCACATATAC	TCGCCaCCGCAGCTACGAA	CCATCTCGCCACCGCAGCTACGAACGGAGC	DROSHA_p.H278R
TTTGCGACATCGTCATCGCATAC	CCAGaCCATCATGTAGCGG	TGCCGCCAGACCATCATGTAGCGGTGGACA	LINS_p.D327G
TTTGGTATCAGTATCAGATCGCA	TACaAGGTGACTTTCCCCT	GTGTTTACAAGGTGACTTTCCCCTTGGGGA	NEK10_p.K535E
TTTGTGTCAGCATCTCATAGCAC	TACaAGGTGACTTTCCCCT	GTGTTTACAAGGTGACTTTCCCCTTGGGGA	NEK10_p.K535E
TTTGTGCACTATATCGTGTATAT	GGGTCaTGACGCCATCAGA	ACACTGGGTCATGACGCCATCAGAGGGCGC	ELP5_p.M1V
TTTGTCATCAGACAGTCACGTCA	GGGTCaTGACGCCATCAGA	ACACTGGGTCATGACGCCATCAGAGGGCGC	ELP5_p.M1V
TTTGTGCATCATCTATCACTAGA	GTCaCTGTTGCCATGGCCA	CCAAGGTCACTGTTGCCATGGCCACGGCCC	HRG_p.H426R
TTTGTAGAGAGCATCTAGTCTAC	GACaGCATCCCCGAAGTCC	TGGCCGACAGCATCCCCGAAGTCCTGGCGG	PCDHGA11_p.S668G
TTTGATCTCATCTATCTAGTACT	GATGaCCTCTTTCCTAATG	CCCTGGATGACCTCTTTCCTAATGAGGAGG	KLC4_p.D177G
TTTGATATCTAGTATATAGTCTA	AAGCaGGGCGAGCTGCAGA	CCGTGAAGCAGGGCGAGCTGCAGAAGGTGA	EHMT2_p.Q660R
TTTGGATCAGCATGTGTATCGTA	AGTCCaAGTAAGGTTGGAG	TCCTGAGTCCAAGTAAGGTTGGAGAGGGGC	TRIP10_p.K66E
TTTGGCATATCATATCGCACTAT	ACGaCGCTCGGCCCGAAGA	TGGTAACGACGCTCGGCCCGAAGATGGCGG	LMLN_p.T4A
TTTGTGTATATATCAGTATCTGT	CTGCaTCCCACCATGACCA	GCCCCCTGCATCCCACCATGACCATGGCCT	ONECUT1_p.H84R
TTTGTCATACATCATCTCACTAT	TTTCaGGGGTTACCTGGAC	TTGTGTTTCAGGGGTTACCTGGACCGGTAG	COL27A1_p.001
TTTGATGTGTGTCATCTCGACAT	TTTCaGGGGTTACCTGGAC	TTGTGTTTCAGGGGTTACCTGGACCGGTAG	COL27A1_p.001
TTTGGTGTGTACAGTAGTCATAC	ATCAaCCAGGACCCCAGCC	ACGCCATCAACCAGGACCCCAGCCAGGTGC	XIRP1_p.N282S
TTTGTCATATGTATATCAGTACA	CTTCaTACCAACACATCGC	AGTCTCTTCATACCAACACATCGCTGGATG	NLN_p.H589R
TTTGGTGTCATACGTATCTATCA	GCGACaTCCGCGCCAGCGT	CATTCGCGACATCCGCGCCAGCGTTGGGGC	MTHFD1_p.I891V
TTTGTCATATCAGAGCATCTAGA	CATCaCCATATTCCCCCAG	TCTGCCATCACCATATTCCCCCAGAGGACA	NOS1_p.T465A
TTTGAGCATCTCATGTCGCATCT	CCAGGaGACCGGGTCCATC	CGCTACCAGGAGACCGGGTCCATCCGGCCT	PAX7_p.E92G
TTTGTGTCACTCATCTACGAGTA	CCAGGaGACCGGGTCCATC	CGCTACCAGGAGACCGGGTCCATCCGGCCT	PAX7_p.E92G
TTTGGTACAGCATCATCTATGTG	CCAGGaGACCGGGTCCATC	CGCTACCAGGAGACCGGGTCCATCCGGCCT	PAX7_p.E92G
TTTGTCACAGTACAGCATACGTA	CCAGGaGACCGGGTCCATC	CGCTACCAGGAGACCGGGTCCATCCGGCCT	PAX7_p.E92G
TTTGTATCATCTAGTACGTGTAC	GTCaCCACGCAGCGAGCCC	TTCGAGTCACCACGCAGCGAGCCCTGGGCC	PRRT3_p.T423A
TTTGTGTATATATCAGATCAGTA	GGGCTaCCCCTTCCACGAC	ACATGGGGCTACCCCTTCCACGACGGGTAA	TM4SF4_p.Y129C
TTTGACATCTAGTCACTAGCAGC	TGGaGCCTCCTAGTGGCCG	TGCAGTGGAGCCTCCTAGTGGCCGTGGGTG	TMEM141_p.S63G
TTTGTATAGTATCATCGTATCTC	CAAaCACGTGGAGAAGGAC	GCCATCAAACACGTGGAGAAGGACCGGATT	PIM1_p.K67K
TTTGTCAGTATCTATCAGTCTAG	CAACCaTGGCATCCAGCCG	GGGTGCAACCATGGCATCCAGCCGAGGGGC	SLC25A10_p.M166V
TTTGATCGTCAGTAGCATATATA	GAGCCaTGTCGCCGCTGCT	CGACGGAGCCATGTCGCCGCTGCTGGGGCT	AQP11_p.M1V
TTTGTATATCTCAGAGCATCATA	AAGaGGGCCAGCTGAGGTA	GGGCCAAGAGGGCCAGCTGAGGTAAGGGCC	HEYL_p.E23G
TTTGAGTGTCTATCACATACTCA	CCATCaACATCACCGTGGT	AAAGGCCATCAACATCACCGTGGTTGGTGT	PDGFRB_p.N307D
TTTGCACGTATCAGTATCAGTAG	CCCaTGTCTGTCCTGAGTG	ACCCCCCCATGTCTGTCCTGAGTGTGGGGG	ZNF687_p.H733R
TTTGCATCACTCATCGTCATCAG	GGTGCaACGGTGGGTAGTG	AGCGGGGTGCAACGGTGGGTAGTGGGGGCT	RSAD1_p.Q89R
TTTGGAGCATCATCATCATAGTC	CGaTGCACTGCCACAAGCC	CGCTACGATGCACTGCCACAAGCCTGGATT	GALNT8_p.D336G
TTTGCATACATCTCACGAGTATC	TGCaGCGCGAGGCTCAGTG	AGACGTGCAGCGCGAGGCTCAGTGAGGACC	CHPF_p.S737G
TTTGTGTCGCATCTAGTCTATAG	CCCaCCCACAGCTACCATG	CAAGGCCCACCCACAGCTACCATGTGGGGC	FAM181A_p.T208A
TTTGCATCAGTCAGTCTAGTATC	CCCCaCTACCTGGGCGCTC	CGCTGCCCCACTACCTGGGCGCTCTGGAGC	CERCAM_p.H48R
TTTGGTCGTCAGTATCTACATCA	CCAaGCGGGAGGTCAGTGT	TCAGGCCAAGCGGGAGGTCAGTGTGGGCGT	AZI1_p.K300R
TTTGTCATCATCTATCATACTCG	GATGaCATCGCAGTCAACT	ACCCCGATGACATCGCAGTCAACTGGGTGG	LRP5L_p.D38G
TTTGATATCTATATCATCGAGTA	GGACGaCACGCAGTTCGTG	TACGTGGACGACACGCAGTTCGTGCGGTTC	HLA-C_p.D54G
TTTGCTGTATCTATCACTACTAT	GGGGaGGGGCTGAGCGTGA	TGCAGGGGGAGGGGCTGAGCGTGACGGGCA	DHRS4L2_p.E77G
TTTGGTGTGTATCATCAGCTAGA	ATaTCAGAAGAAAATCTTT	AAAAGATATCAGAAGAAAATCTTTTGGAAG	SYCP1_p.I673M
TTTGCATATCTATCAGCATCACG	ATaTCAGAAGAAAATCTTT	AAAAGATATCAGAAGAAAATCTTTTGGAAG	SYCP1_p.I673M
TTTGTATATCTATAGTCATCATA	ACACaTTGTCTGGCCTCAC	CTGCTACACATTGTCTGGCCTCACAGGTGG	GTDC1_p.I286V
TTTGTCATCACTGTATCGCAGCT	CGCTaTCGCCACCTGGACA	AGTACCGCTATCGCCACCTGGACATGGCCG	GCAT_p.Y176C
TTTGATAGCATCTATGTACGTAT	TGTaGGTGGCAGCAACCTC	GGCCTTGTAGGTGGCAGCAACCTCAGGAGA	LEPRE1_p.001
TTTGTCATACACATATATCGTAT	ACTaCGCTTGGTCGCCGCC	CTCCTACTACGCTTGGTCGCCGCCCGGCAC	ILDR2_p.Y566C
TTTGATCTCATCTCACGAGTAGT	GAaCCACGCCAACGTGGTG	AAGCTGAACCACGCCAACGTGGTGCGGCTC	PTK7_p.N854S
TTTGAGCAGTATCTACATCTAGA	GAaCCACGCCAACGTGGTG	AAGCTGAACCACGCCAACGTGGTGCGGCTC	PTK7_p.N854S
TTTGCATGTATCAGAGTAGTATA	CCCaATGACCCCAGCTTTG	TGGTGCCCAATGACCCCAGCTTTGAGGACA	ACVRL1_p.N431D
TTTGACTAGTATCTAGTATCAGT	GGCaGCAAGTCCATTTCTA	TGTCTGGCAGCAAGTCCATTTCTATGGCTG	OR2M2_p.S89G
TTTGCTATCACAGTACTATCATA	GGCTaCGTGGCTGACCTGC	TGGGGGGCTACGTGGCTGACCTGCTGGCCC	DNAH3_p.Y3941C
TTTGGTATATCATCTGTCTACGT	TGCCCaATTGCGAGGTTGT	GATGCTGCCCAATTGCGAGGTTGTGGGAGT	ATP5SL_p.N228D
TTTGTCACTAGATATCAGTATAG	CACaCCACGCAGGTGGGAA	GGGCTCACACCACGCAGGTGGGAAAGGGCC	FAM120B_p.H864R
TTTGATGTCTATCAGCTATATCT	CATCaCCACCACTGCCCAG	GATGCCATCACCACCACTGCCCAGAGGTGA	PFKL_p.T240A
TTTGTGAGTATATCACTACATCA	TGCaGCTCTGGGACACAGC	GCGACTGCAGCTCTGGGACACAGCTGGTCA	RAB6B_p.Q65R
TTTGGCTATCTATCATATATAGT	AGGCaGCTCTCACCTGCGG	GGGGGAGGCAGCTCTCACCTGCGGCGGTGC	GIGYF1_p.S272G
TTTGCTCATGTCAGATCGTCAGA	ATaCCACGAAGAGTTCGCC	GAGCTATACCACGAAGAGTTCGCCCGGGCG	SCIN_p.Y6C
TTTGTATCATCTCAGTGTGTAGT	TGCTTaCTGCCAGCGGCTG	GGTCCTGCTTACTGCCAGCGGCTGTGGCCA	TMCO6_p.Y415C
TTTGCAGTCTCATCTATCTCTAG	CCTaCCCATGCCGTGTGTG	AGATGCCTACCCATGCCGTGTGTGTGGTGG	PADI1_p.T15A
TTTGGTGATCTATCGTCTATCAG	AGTGCaTGGGTCGGCCGCG	AGCTCAGTGCATGGGTCGGCCGCGCGGACG	C16ORF93_p.H36R
TTTGCTATCATCTCATCGATCTC	GTGGaCGCTGCACCCCCGG	TCGAGGTGGACGCTGCACCCCCGGTGGACC	KRT32_p.D254G
TTTGGATCACAGTACAGCATAGT	GAGCCaTGGCGCACCAAAC	GCGCCGAGCCATGGCGCACCAAACGGGCAT	TWF2_p.M1V
TTTGTCACAGATCTAGCTATCTA	AGGTaCACACTGACGGAGG	GTCGCAGGTACACACTGACGGAGGGGGACT	C19ORF26_p.Y147C
TTTGCGTCAGCATCTATCTCTAC	TGGaGGATGGGTGTGGCCC	GGCCCTGGAGGATGGGTGTGGCCCTGGGCC	TRIM47_p.E344G
TTTGGAGTCAGTGTATCATCACG	GGTCaTCGAGCAGCTCGGT	TGCAGGGTCATCGAGCAGCTCGGTGGGAAG	ATP6V1H_p.I410V
TTTGTGCATATGTCATCATCTAG	CCAaCCCAGCAGTGACCTT	CCTGTCCAACCCAGCAGTGACCTTTGGCAC	CHRM4_p.N192S
TTTGCACTCACAGCATCGAGTCG	ATGaGGTCAACGTGGCCCG	GAGCGATGAGGTCAACGTGGCCCGTGGTGT	CRTAC1_p.E164G
TTTGATCATCATAGTCATCTATG	CCTCaGGTCACCATCCTGG	GACTCCCTCAGGTCACCATCCTGGAGGCAG	IL4I1_p.001
TTTGGACATCATGTCAGCAGTAC	ACTCAaACGCTGACATGTA	GCACCACTCAAACGCTGACATGTACGGTCT	KDR_p.Q441Q
TTTGATCATCGTCTAGCATCGTC	ACTCAaACGCTGACATGTA	GCACCACTCAAACGCTGACATGTACGGTCT	KDR_p.Q441Q
TTTGTCAGTATATATAGTATCGC	ACTCAaACGCTGACATGTA	GCACCACTCAAACGCTGACATGTACGGTCT	KDR_p.Q441Q
TTTGTACATCTCATCGTCAGCTA	ACTCAaACGCTGACATGTA	GCACCACTCAAACGCTGACATGTACGGTCT	KDR_p.Q441Q
TTTGTCTCTCATCGCATAGTATC	GGAGCaGGTGTTCCCCCTG	CTCTTGGAGCAGGTGTTCCCCCTGGGGACT	PML_p.A779A
TTTGATCATCTGTATACGTCTAC	AGTaCAGTCCCTTCAGCAG	CTCAGAGTACAGTCCCTTCAGCAGAGGGCA	PRX_p.T1173A
TTTGGATCACAGTATCGTCTATC	GTGGaGCGGTACATCGCCT	CTGACGTGGAGCGGTACATCGCCTCGGTGC	RANBP2_p.E9G
TTTGAGTCTAGTATCTAGTACAT	GGTGGaTGCAGCCCAGGCC	GGGCTGGTGGATGCAGCCCAGGCCCGGCCC	AOC3_p.D85G
TTTGGAGCATATATCATCTCACA	GAGTGaAGGTGAGAGGCGC	CACAGGAGTGAAGGTGAGAGGCGCCGGGCA	ACOXL_p.K53E
TTTGGTAGTATATCAGTCACGTC	CCAaCTCAGACTCCATGCG	ACACCCCAACTCAGACTCCATGCGAGGTGA	C12ORF53_p.N144S
TTTGCAGTCGCATCTCTATCGAG	TGAGAaCCCCTTCGCCCAG	GCTGATGAGAACCCCTTCGCCCAGGGGGCC	GSN_p.N268S
TTTGCTCATCGTCATCTCAGCTG	CCTCaAGTGTGTAGGTAAG	CATCACCTCAAGTGTGTAGGTAAGTGGGGC	CRELD1_p.K242E
TTTGCGCTATCTATCATCAGCAC	GGGCTaCATGAAATCCAAG	ATGCTGGGCTACATGAAATCCAAGAGGCGG	KCNE4_p.Y57C
TTTGGTATCAGTATATCATGTCT	ACTTaCACCGTGCTCTACC	ACCCAACTTACACCGTGCTCTACCTGGGCA	FAM43A_p.Y70C
TTTGCTAGAGCAGTATCTACATC	GACAaCTTCATCCAGGCCC	TGGCTGACAACTTCATCCAGGCCCTGGGGC	LRFN4_p.N58S
TTTGATCGTATCTATCAGCATAT	GACAaCTTCATCCAGGCCC	TGGCTGACAACTTCATCCAGGCCCTGGGGC	LRFN4_p.N58S
TTTGTATCAGCATCTAGTATCGC	TTGTaCCCCACTCGGGCCA	TGCCTTTGTACCCCACTCGGGCCATGGGCT	BCL3_p.Y92C
TTTGTAGAGTATATCATCGTCAC	AATCaTATTGTTGCAGCGA	CGCAGAATCATATTGTTGCAGCGATGGTTC	MYO9A_p.I1024V
TTTGCATATGTCACATATATAGT	CCATCaGCCGGGGGAAGAA	CTGTGCCATCAGCCGGGGGAAGAAGGGTGA	ZBED4_p.S485G
TTTGATCGTGTCTAGCATCGTCA	GCCaTGTCCATTCCCATGT	ACAAGGCCATGTCCATTCCCATGTGGGTGG	CD163_p.M884V
TTTGGTCACTCATCTAGTCTACG	CCCaTGCGGGGCACGAGTG	TGGGGCCCATGCGGGGCACGAGTGTGGGCT	CHDH_p.M427V
TTTGCGAGTATATCAGAGCTAGC	CCCaTGCGGGGCACGAGTG	TGGGGCCCATGCGGGGCACGAGTGTGGGCT	CHDH_p.M427V
TTTGTGTAGCATCATATATCTAG	CCCaGGCTGAGGCGTCCCC	GCTGCCCCAGGCTGAGGCGTCCCCCGGACC	NOP16_p.Q162R
TTTGGTAGCACTAGCATCGTCAC	GGAGTaCACAGTGCATGTC	GGTGTGGAGTACACAGTGCATGTCTGGGCC	TNN_p.Y596C
TTTGACATATATATCAGTATCTC	GGAGTaCACAGTGCATGTC	GGTGTGGAGTACACAGTGCATGTCTGGGCC	TNN_p.Y596C
TTTGGTATCATCTCACGACATCG	GTGCCaGTACGCCGTGGAA	AGTCCGTGCCAGTACGCCGTGGAAAGGCCC	PITX3_p.Q295R
TTTGTACTCAGTATCTATCGTCT	CTGaCACCACCGCACCATC	TGAGCCTGACACCACCGCACCATCAGGGCA	CACNA1E_p.D1681G
TTTGCTACATCATACAGTCTAGC	TGCTCaCGGTCAACGAGCG	CTACGTGCTCACGGTCAACGAGCGGGGCAA	SMYD2_p.T44A
TTTGCTCGAGTCATCACTACTAC	GCCaTCCCGCCGGGCTGCG	AGAAGGCCATCCCGCCGGGCTGCGGGGACG	CPLX1_p.I101V
TTTGCAGAGAGAGTATATATATC	ACCCaGAAAAGCCTGCCTC	AGGCCACCCAGAAAAGCCTGCCTCAGGGGC	TTF2_p.Q305R
TTTGTGTATCTCTATCGAGTCTA	CCCGGaCGCACGGGCTGCT	GTCAGCCCGGACGCACGGGCTGCTGGGTAC	ITIH1_p.T827A
TTTGATACAGTCAGTAGTCTAGT	TCCTTaCTGCCATGGATGG	CCTGGTCCTTACTGCCATGGATGGCGGCGA	PCDHGA6_p.T213A
TTTGCATCTCACTATCTATCAGC	TCCTTaCTGCCATGGATGG	CCTGGTCCTTACTGCCATGGATGGCGGCGA	PCDHGA6_p.T213A
TTTGGCAGTATCGTGTATCATAC	GAGaCaTGGCTTACGTCTT	GCCCCGAGACATGGCTTACGTCTTCGGTGG	VPS33B_p.D508G
TTTGCATAGTCTATATATCATCG	ATATaCAAAGTCCGGGAGA	CGCCCATATACAAAGTCCGGGAGAAGGTGA	C10ORF122_p.Y56C
TTTGACAGTAGTCGTCATCATAT	ATATaCAAAGTCCGGGAGA	CGCCCATATACAAAGTCCGGGAGAAGGTGA	C10ORF122_p.Y56C
TTTGTGTCATCATCATCACTATG	CGGCAaGGCCGCCAAGGCC	CTGAGCGGCAAGGCCGCCAAGGCCCGGGAC	DOT1L_p.K1409R
TTTGATCATCATACGTGTCATAT	GGCCaGGACAGTGGCTCCC	CTATGGGCCAGGACAGTGGCTCCCAGGCCC	PLEKHH1_p.Q202R
TTTGTAGAGCATCACTATCTATA	CTGGaCAGCCTGGCCGTGC	TGGACCTGGACAGCCTGGCCGTGCTGGTGA	MTX1_p.D171G
TTTGTGTGTAGTCAGTATCAGTA	CGAGaCAAGGTGCGCTTCC	AGCTGCGAGACAAGGTGCGCTTCCCGGCTT	TAS1R2_p.D173G
TTTGACTATCATAGCATCTATGC	CACTaTTATGCCGTGGCTG	GAACTCACTATTATGCCGTGGCTGTGGTGA	LTF_p.Y111C
TTTGTCTATCTATCATATATATA	CGCaAAGGTCGTGGATCCA	GTGGACGCAAAGGTCGTGGATCCAAGGTTT	MLL4_p.K1260E
TTTGGTCGCATCAGCATACATCA	GCCaTGGTGTCCCGGGACC	CGCCCGCCATGGTGTCCCGGGACCAGGCTC	PTK6_p.M1V
TTTGCAGATATCGTCTATCTAGC	AATaCGGTCCTATGGCTGG	GCCGAAATACGGTCCTATGGCTGGTGGCAC	MET_p.Y666C
TTTGCTATCAGTACATCTCATGT	AATaCGGTCCTATGGCTGG	GCCGAAATACGGTCCTATGGCTGGTGGCAC	MET_p.Y666C
TTTGGTATCAGTCTCTACGACTA	GCCCaGCAGTGGCTCACAC	CCCCGGCCCAGCAGTGGCTCACACAGGTCA	ZDHHC8_p.S661G
TTTGGTATATATCAGTATCATCT	CAGaTGGGCGGCGGGCAGC	CTCACCAGATGGGCGGCGGGCAGCAGGTGT	FDXR_p.D275G
TTTGATGTCGCATCGTCATCGCA	ACGaGCCCCCGCCACGTGG	CTGGGACGAGCCCCCGCCACGTGGAGGCAG	SYDE2_p.E118G
TTTGCTATGTATCATCTCACGTA	ACCaAAGCAGGAGTGACAC	GGTTTACCAAAGCAGGAGTGACACAGGACC	TEX35_p.K45E
TTTGCACTATCTATCAGTCAGTG	GCAGCaGGGCGGTGCCCCA	CTGCAGCAGCAGGGCGGTGCCCCAGGGACA	PKNOX2_p.Q388R
TTTGTCTCACAGCAGTAGTATGT	GCAGCaGGGCGGTGCCCCA	CTGCAGCAGCAGGGCGGTGCCCCAGGGACA	PKNOX2_p.Q388R
TTTGCACATCATAGCATCTACTA	GCCAaCGAGGTAGCCTGCA	TCGACGCCAACGAGGTAGCCTGCAGGGTCT	KCNH4_p.N529S
TTTGGTATCGAGTAGTCTATCAT	CAATaGTGAGGTTGCCCAG	AAGGCCAATAGTGAGGTTGCCCAGTGGAGA	MYH3_p.S1367G
TTTGTCAGTCTATCGTCATACTA	AGGaGCAGGGTGCCCAGCT	AGCTGAGGAGCAGGGTGCCCAGCTCGGGGT	TMEM132A_p.E720G
TTTGGATCGTCACTATCATATAT	GACCaCATGCTGGCCTAGG	CTGCAGACCACATGCTGGCCTAGGCGGCCT	JUP_p.H742R
TTTGGTCTACAGTCAGTCTCATA	TGATGaCAGGAGGTAACAT	GTCCATGATGACAGGAGGTAACATTGGAAA	PTGR2_p.T334A
TTTGTATCTATCATCACACTACG	GCAGCaCTGGAGGAGGCGG	CGGAGGCAGCACTGGAGGAGGCGGCGGCGG	KCNN2_p.T90A
TTTGAGTATCATCACATACATCA	ACCCCaAGCACCCCGGAGC	CAGGCACCCCAAGCACCCCGGAGCCGGGCA	MLL4_p.Q204R
TTTGTGTCATCATCACTCAGCGA	GACaGTGTGCTTCTGGGAC	TTTGTGACAGTGTGCTTCTGGGACTGGGGC	CAMTA1_p.001
TTTGATAGTCATGTGTATCATCG	GACaGTGTGCTTCTGGGAC	TTTGTGACAGTGTGCTTCTGGGACTGGGGC	CAMTA1_p.001
TTTGAGCATGTATATCATCTGTA	GACaGTGTGCTTCTGGGAC	TTTGTGACAGTGTGCTTCTGGGACTGGGGC	CAMTA1_p.001
TTTGGTCTCATCATCTCAGTGTG	GACaGTGTGCTTCTGGGAC	TTTGTGACAGTGTGCTTCTGGGACTGGGGC	CAMTA1_p.001
TTTGCAGTCTAGCAGTCTATCGA	CTACaGAAACCTGGAGGCC	ACCTCCTACAGAAACCTGGAGGCCCGGCGG	PTK2B_p.001
TTTGAGTATCATCATCATCACTA	GCTaTGTGGGAGCCGTCGG	CTGGCGCTATGTGGGAGCCGTCGGAGGCTT	SERINC5_p.Y156C
TTTGCGCATATCATCTAGCGTAG	CAaGGCGGCGTCCCGGGGC	GAGGCCAAGGCGGCGTCCCGGGGCCGGCAG	HMHA1_p.K736R
TTTGGTATAGTATATCAGCAGAC	CCAaGTGGAACCCCCGGAC	CGGGGCCAAGTGGAACCCCCGGACCGGGAG	AEBP1_p.K850R
TTTGGCATAGTATCATCGTCAGC	CCAaGTGGAACCCCCGGAC	CGGGGCCAAGTGGAACCCCCGGACCGGGAG	AEBP1_p.K850R
TTTGTACTCAGAGCTAGTATCAT	CCCCaTCCAGCCGCATCCC	ACACGCCCCATCCAGCCGCATCCCGGGACC	BCL2_p.H58R
TTTGTCGTCTACTCAGTATAGTC	CTCCTaCTCCGGCAGCTCC	TACCCCTCCTACTCCGGCAGCTCCCGGCGG	TCF3_p.Y153C
TTTGCAGATATCAGTATCGTATA	GCCaGGATCCAAACCCCGC	CCCAGGCCAGGATCCAAACCCCGCAGGCCT	CD5_p.Q368R
TTTGGTGTATAGTCTAGTATCGT	ATCGaGCACTCACGCTGCG	TGCGTATCGAGCACTCACGCTGCGAGGCCT	PCNT_p.E2725G
TTTGGAGCATCTATAGTATATCG	GGaCCAGCTGCTGCGGCAG	GACGTGGACCAGCTGCTGCGGCAGCGGGCG	FAM129C_p.D343G
TTTGGATCTCAGTATCATATCGT	CATCaAGCGGGCAATGAAG	CGCTTCATCAAGCGGGCAATGAAGCGGCAC	AMPD2_p.K316E
TTTGTCATACACTATCATCGCGT	TCCCaCAAGCCCCTCAACA	GCAAGTCCCACAAGCCCCTCAACATGGGCA	C4B_p.H616R
TTTGATAGTCATCATGTCATCGT	ACTGaGAAGCAATGTCCGG	TTGCTACTGAGAAGCAATGTCCGGAGGACC	MED17_p.E360G
TTTGACAGATCGCAGTATCATCG	GACaCCCACCTGGGCGGTG	CCGGCGACACCCACCTGGGCGGTGAGGACT	HSPA2_p.T229A
TTTGCTCATCATAGTCTACTACT	GGCaAAGTGAAGCAGCCAC	AAGAGGGCAAAGTGAAGCAGCCACAGGAAG	NUTM2B_p.K546E
TTTGTATCGTATCTATCTCTACG	ACaGACCCGAGTTCTTCAG	CCCATACAGACCCGAGTTCTTCAGCGGCTG	EPS8L1_p.R399G
TTTGTCATGTCTATCACATACAT	AGCaGCCAGGACAGCAGCA	GGGCAAGCAGCCAGGACAGCAGCATGGATC	SLC4A5_p.S79G
TTTGTACATCTCATACATCTAGT	GCACaGGAGATCCTGCGTA	TGGAGGCACAGGAGATCCTGCGTACGGACA	FLOT2_p.Q273R
TTTGCATCGCACTAGCATCGTCA	GCACaGGAGATCCTGCGTA	TGGAGGCACAGGAGATCCTGCGTACGGACA	FLOT2_p.Q273R
TTTGTCGCATCGTCTATAGTATC	ATGaCCTTCTTCCTGGCCC	CCCTCATGACCTTCTTCCTGGCCCTGGGAC	SLC29A2_p.T435A
TTTGTGCACTCATCTAGCATATA	TGACCaGGCCAGGGGAGGG	GCTCCTGACCAGGCCAGGGGAGGGTGGCAC	PTPRM_p.R357G
TTTGATCTACATCTAGTACATAC	TGACCaGGCCAGGGGAGGG	GCTCCTGACCAGGCCAGGGGAGGGTGGCAC	PTPRM_p.R357G
TTTGTGTATATCAGCAGTCTATA	GGAGCaCCAGCCTGGTGAG	GCACGGGAGCACCAGCCTGGTGAGTGGCCG	AEBP1_p.H220R
TTTGCATCTCACATAGTATCAGC	GGAGCaCCAGCCTGGTGAG	GCACGGGAGCACCAGCCTGGTGAGTGGCCG	AEBP1_p.H220R
TTTGCTCAGTACATCATACGCTA	CCACCaCTGCCCTGGCGGC	GGCGGCCACCACTGCCCTGGCGGCGGGCGG	AP5B1_p.T102A
TTTGACACTGTATCAGTAGCTAT	CCACCaCTGCCCTGGCGGC	GGCGGCCACCACTGCCCTGGCGGCGGGCGG	AP5B1_p.T102A
TTTGCTGTCATATGTCATATACG	ACCCCaAGGTCAAGGCCCA	GGGCAACCCCAAGGTCAAGGCCCATGGCAA	HBE1_p.K60E
TTTGCTGTCAGTCTATCTCTATA	TACaCCGTGTCCTCGGAAG	GCATCTACACCGTGTCCTCGGAAGTGGCCG	HTR1E_p.T320A
TTTGATGTCAGCAGTATATCTCG	GAGGaGGCGGCGGCCGCGG	GCGTGGAGGAGGCGGCGGCCGCGGCGGCCT	SFPQ_p.G21G
TTTGCGTATCACTATATCATCGC	GGCTGaCGCTGCTGGCTGT	GGCTGGGCTGACGCTGCTGGCTGTTGGGGT	ATAD3A_p.T303A
TTTGAGTATCTATCACTAGCATG	CCAaGACAAGCAGGCGCCA	GGGGTCCAAGACAAGCAGGCGCCAGGGATC	FLG_p.K1585R
TTTGCATGTAGCTAGTATCATCT	TGTaTGAGTGCGCGACTTG	GAAACTGTATGAGTGCGCGACTTGCGGTCA	ZNF333_p.Y534C
TTTGTGCTCATCATCACATACTC	AGCAaCTTGCTGGATCTGG	AGCCCAGCAACTTGCTGGATCTGGTGGTAA	NCR1_p.N111S
TTTGGTATCGTCATCTAGCTATA	GACaAGTGTCCTCCCGAGC	CCAGCGACAAGTGTCCTCCCGAGCTGGAGA	FCGBP_p.K3848E
TTTGGCTCATCACTAGCAGTATA	GGTGaCTCAAAACCCCCAC	AAATGGGTGACTCAAAACCCCCACAGGCCA	PHC1_p.D721G
TTTGCATGTATCGTATCTATCAC	CTGaCTCCCCTCCCACCCA	GTCCACTGACTCCCCTCCCACCCATGGCCA	SPATA19_p.D74G
TTTGTGTGATCTATCATCGCATC	GCaATTTCAGTGCGGCCGA	TCTGTGCAATTTCAGTGCGGCCGATGGCGG	LY6E_p.N99D
TTTGATGCAGTATCTATATCGCT	TCTTaGCCGCTATGCACAC	TGGACTCTTAGCCGCTATGCACACTGGGTG	TNPO1_p.S463G
TTTGTGCATCATATCATCACTAC	CAGaGTGAGCTGGGCTACC	TGGACCAGAGTGAGCTGGGCTACCTGGCCA	LRRN2_p.S87G
TTTGAGTATATATCAGCTATCAT	TACCaGGGCCACGTGCGGC	AGCTGTACCAGGGCCACGTGCGGCTGGTCT	SLIT3_p.Q1210R
TTTGAGCAGTCTCTATCGCAGTA	GTCaCCGCCATTGGTGCTG	CTGAGGTCACCGCCATTGGTGCTGTGGAGG	PKLR_p.T455A
TTTGTCAGTCATCTCAGCATAGC	GTGGCaGAGCGGCCAGCGC	ACCGAGTGGCAGAGCGGCCAGCGCTGGGAA	APOE_p.Q39R
TTTGTCATCGCATATCTATCTAG	GTCaATGGCCAGCCCCCGC	CACCGGTCAATGGCCAGCCCCCGCTGGGCA	EEF1D_p.N217D
TTTGTGTCGCAGTCTAGTATCGT	ATGCCaATGGCCAGCGCAT	TGGCCATGCCAATGGCCAGCGCATTGGCCG	PCOLCE2_p.N99D
TTTGTATCTATCATCTACGACTA	TCCaGGGCCCTGGAGACAA	CTTGATCCAGGGCCCTGGAGACAAAGGGGA	C7ORF36_p.Q11R
TTTGTCGCACTCATCGTCAGAGC	TCCaGGGCCCTGGAGACAA	CTTGATCCAGGGCCCTGGAGACAAAGGGGA	C7ORF36_p.Q11R
TTTGGTATATCACTAGTACAGAG	CCTaTCGATGTCCTGAGTG	CAGGCCCTATCGATGTCCTGAGTGTGGCAA	ZNF774_p.Y431C
TTTGCTGCATCTATCATCATCAC	GAGCaGAAGACTCAGCTGG	CAGAGGAGCAGAAGACTCAGCTGGAGGTAG	PPP1R14D_p.Q108R
TTTGGCATCATCATGTAGTCACT	TATaCCGTGCTGCCGGGGC	GGGAGTATACCGTGCTGCCGGGGCTGGACT	PAOX_p.T212A
TTTGTGTCGTCAGCATCTATCTC	TGCaGGCCCGGGCCTATGT	CATCTTGCAGGCCCGGGCCTATGTGGGACC	ATP13A2_p.Q377R
TTTGCACTCGTCTATCGTCTATA	AAAaGGAGCAGCCCTGGCC	GGGGGAAAAGGAGCAGCCCTGGCCTGGAAG	IGSF3_p.R1001G
TTTGACGTCATACATCATCGTCA	GGACaCGGTAAGTGCAGTG	ACCGTGGACACGGTAAGTGCAGTGTGGCGC	PMPCA_p.T129A
TTTGGACAGCATCATCATCGCTA	TGAGCaGGGGGCTGCTCCA	GCTGCTGAGCAGGGGGCTGCTCCACGGCTG	ADCY9_p.R284G
TTTGGTCATATATCATCTCTAGC	TCAGaCCCCGCCTCGCCGG	AGTCCTCAGACCCCGCCTCGCCGGCGGCCT	CCDC88C_p.D1441G
TTTGCATCTCACTAGCTATCTAT	ACCAaCCGAATGATTGCAG	GAGACACCAACCGAATGATTGCAGAGGTAA	KIF6_p.N208S
TTTGACATCTATCACTAGCATCA	CGGGGaTGGAAGTGTTGGC	TGTGGCGGGGATGGAAGTGTTGGCTGGGTC	DGKD_p.D336G
TTTGGACAGTATCTCTACATCAT	GGaGTTCTCGGCTCGCTCC	GGCGCGGAGTTCTCGGCTCGCTCCAGGAAG	CCNE1_p.E23G
TTTGTATCTATCACTATCTACGC	AAGGTaCCAAGGCAGGGAG	GACCCAAGGTACCAAGGCAGGGAGGGGCCT	CCL21_p.001
TTTGTACATATCAGCATCTAGTC	TTCTaCCTGTCGGACCAGG	CCGCTTTCTACCTGTCGGACCAGGCGGTGC	ACTRT2_p.Y137C
TTTGAGTCAGTACAGTAGTCTAT	GTCaAAGCGCTGGAGCCCG	CGCTGGTCAAAGCGCTGGAGCCCGAGGAGC	NDN_p.K169E
TTTGACACATATATCATAGTCTC	GGATCaCAAACCAGGTCCA	CCAGCGGATCACAAACCAGGTCCATGGTTT	PSMD7_p.T192A
TTTGAGTCATGTCTATCGCAGTG	GCGTaCCTGAACATGACGC	GGGCCGCGTACCTGAACATGACGCAGGACC	CHD5_p.Y1811C
TTTGTATCTCGTCATACGTCTAC	AGAaTGGTATTTCCCACCG	CCTGCAGAATGGTATTTCCCACCGCGGATG	BRF1_p.N88S
TTTGTGTCAGTCTAGATATCTAT	GTCaCTGAGTCCTCCAATC	CGGAGGTCACTGAGTCCTCCAATCAGGACG	PER1_p.T1028A
TTTGCTCTCATCTCAGCTATCAT	TGCAAaCCAAGCCAACCTC	ATGATTGCAAACCAAGCCAACCTCTGGCTT	TAS2R38_p.N103S
TTTGCGCATATCATCTATAGCTC	TGCAAaCCAAGCCAACCTC	ATGATTGCAAACCAAGCCAACCTCTGGCTT	TAS2R38_p.N103S
TTTGTACATCGTCATCGCTATAT	GGCCaCCATGTCTGCCTCC	TCCAGGGCCACCATGTCTGCCTCCTGGTGA	AP3D1_p.H1073R
TTTGTCTGTCATCATCTCGCGTA	TCCaTCCCTGATGAAGATG	AAGTGTCCATCCCTGATGAAGATGGGGAAA	C14ORF93_p.I107V
TTTGTACTCACTAGTCAGCAGAG	GGCCTaCCCGGCCTTTCTG	GGCGTGGCCTACCCGGCCTTTCTGGGGCCC	SPSB4_p.Y161C
TTTGCATATCATCATCGCAGTCT	GGCCTaCCCGGCCTTTCTG	GGCGTGGCCTACCCGGCCTTTCTGGGGCCC	SPSB4_p.Y161C
TTTGATAGTATCAGTACAGCTAG	AGTTaTGAGGACCCACCCC	GGGAGAGTTATGAGGACCCACCCCAGGTGA	SNCB_p.Y119C
TTTGTATCTATCATCTCACAGCT	AGTTaTGAGGACCCACCCC	GGGAGAGTTATGAGGACCCACCCCAGGTGA	SNCB_p.Y119C
TTTGTATATCAGAGTCATCTCAC	CCAGGaAAAGCTGGCCAAT	GGAAGCCAGGAAAAGCTGGCCAATGGGGAG	PCDH7_p.E1132G
TTTGTAGTACAGTAGTATGTATC	TCCaGCAGCTACAAGACCT	CGGCCTCCAGCAGCTACAAGACCTGGGGCT	MFGE8_p.S250G
TTTGGAGTCATCACGTCACGTCA	GTCAGaTGGGAATCTAATT	GAGAGGTCAGATGGGAATCTAATTGGGCAC	ZBTB43_p.D331G
TTTGAGTCTATCACATATATCTG	GTCAGaTGGGAATCTAATT	GAGAGGTCAGATGGGAATCTAATTGGGCAC	ZBTB43_p.D331G
TTTGGTGTCATACATCATCACGA	TGCaCTCCGAGGTGGGCGC	GGGCCTGCACTCCGAGGTGGGCGCAGGGCC	GAK_p.H887R
TTTGTAGTGTAGTATATCAGCTC	GGAGAaGCTCTTCCAGGCC	GGGCTGGAGAAGCTCTTCCAGGCCCGGAAG	SPATA20_p.K503R
TTTGTGTGTATCATCACAGCATC	GGAGAaGCTCTTCCAGGCC	GGGCTGGAGAAGCTCTTCCAGGCCCGGAAG	SPATA20_p.K503R
TTTGTCTAGTATCAGCATCGAGA	GGCTaAGAAGGCGGGCCTC	GAGCTGGCTAAGAAGGCGGGCCTCAGGGGG	TMEM215_p.K113E
TTTGCATGAGTCATCATCTACGA	TGTCCaCCGGAGAAGCCTT	CAGGGTGTCCACCGGAGAAGCCTTCGGGGC	ALOX15B_p.T10A
TTTGCAGAGTAGCATCATCTACA	GCTCTaCCTGCACAGGCAG	GTTCAGCTCTACCTGCACAGGCAGTGGCTG	CYP4A11_p.Y38C
TTTGCATCAGCAGTATCTACTAC	TGGaGCTGCTCACGCCGCG	CTGCATGGAGCTGCTCACGCCGCGCGGCTG	UBE2QL1_p.E90G
TTTGGTACTCATCTCAGAGTACG	TCCaTGAAAGTATTGGAAG	TTAACTCCATGAAAGTATTGGAAGAGGTTA	CCDC148_p.M157V
TTTGAGTCATATGTCTATCAGCA	GAGGaGTGCAAGGCGCTGC	CGAGGGAGGAGTGCAAGGCGCTGCTGGACG	RGS9BP_p.E5G
TTTGTAGCACTATCTATCATCTC	TGCaGACGCACTGTCAGCA	ACAGGTGCAGACGCACTGTCAGCATGGAGA	SLC10A1_p.R251G
TTTGACTCATCACGTCATCAGCT	GGCaAGACAAGTGGGTGAA	AGAATGGCAAGACAAGTGGGTGAACGGCAA	TPMT_p.Q30R
TTTGCTATATCGTCTAGCTATCT	CCaTGCTTGGAGCTATGTT	GGATTCCATGCTTGGAGCTATGTTTGGGGG	KCTD6_p.M37V
TTTGATGTATCTACAGTCTATAC	CCGGaAGAGTCCGGCCCGG	CCGGCCCGGAAGAGTCCGGCCCGGAGGAAC	VHL_p.E41G
TTTGATCGTCAGCATACTCATCT	GCCaCCCCCAGGCCTACCA	CTTCGGCCACCCCCAGGCCTACCAAGGACC	SNX9_p.H150R
TTTGCTAGAGATCATCGCATCGA	CGAaCAGCCACGGTCCGGG	AGCAGCGAACAGCCACGGTCCGGGCGGGTG	AURKB_p.T177A
TTTGGCATCACTATCATGTAGTA	AGTCAaCGTCAGCCTGCCC	GGAACAGTCAACGTCAGCCTGCCCAGGTGG	OSBPL7_p.N622S
TTTGGTACTCATCTCACTACATA	TATGTaCCTTACTCGAGAG	TTCAATATGTACCTTACTCGAGAGCGGCGC	HOXA10_p.Y343C
TTTGAGATCGCAGTATATCAGAG	CCTaTGTGTGCAGTGTATG	GAAGCCCTATGTGTGCAGTGTATGTGGGAA	ZNF250_p.Y227C
TTTGTCATCATCATCATAGAGTA	CACaCCGGGCTGGACAGGC	GGTTCCACACCGGGCTGGACAGGCAGGGCA	INHA_p.T135A
TTTGTCTAGTATCAGTCAGTACG	CTGGaGCACAGCGAGGACG	GCAAGCTGGAGCACAGCGAGGACGAGGGCA	LRRK1_p.E1239G
TTTGCTCGTCAGCATACATCATA	GGGCTaTATGTGGGAAGCA	GGTCAGGGCTATATGTGGGAAGCATGGATT	C1ORF87_p.I347V
TTTGTCAGAGAGCATCGTCTATC	CTaTGTCAGCTGCCATGGC	TGTTTCTATGTCAGCTGCCATGGCAGGCCT	KLF5_p.M256V
TTTGGACATCATATCATAGCGAG	GCCaCCAGGTCGCATACCT	CTGTCGCCACCAGGTCGCATACCTGGGGCT	MYO1G_p.H620R
TTTGTCACTCAGCATCATCTACT	CAAGaCCTTGCACACATCC	TCCCCCAAGACCTTGCACACATCCAGGAGA	COBLL1_p.D309G
TTTGCTCATATGTCATATATATC	CGCTGaGGGGCAGCCACCG	GGGGCCGCTGAGGGGCAGCCACCGGGGGCC	POM121_p.E711G
TTTGATGTATAGTCTATCGTCTA	CAGCaTGACCAGCACTCGT	GAGATCAGCATGACCAGCACTCGTTGGCGG	AMBP_p.M22V
TTTGCGCAGTAGTCATCTATCGC	GTACaCACGCCGCGAGTGC	AGAATGTACACACGCCGCGAGTGCGGGTGG	CPSF1_p.H137R
TTTGCTCATGTCAGATCATCGCT	CCACaTTGACCGTGTCTAC	CAGCGCCACATTGACCGTGTCTACCGGGAT	KIAA1522_p.I237V
TTTGGCAGTATCATCATCATGAC	CGCTaCCGGCCGGGCACCG	CCCACCGCTACCGGCCGGGCACCGTGGCTC	HIST1H3A_p.Y42C
TTTGGTGTATCATCTATCACGAT	TGTGCaGGTGAGCGGCGGG	GATCATGTGCAGGTGAGCGGCGGGCGGCGG	EBF3_p.S162G
TTTGGATCAGAGTCTATCATCAT	GTGGCaGCAGCGTTGGTGG	CAGAGGTGGCAGCAGCGTTGGTGGTGGCAC	PDE11A_p.S70G
TTTGGATCATCATCATCACTATA	GCCGCaTCGCGCAGGACCT	CGTGGGCCGCATCGCGCAGGACCTGGGGCT	PCDHA9_p.I48V
TTTGTCATAGTATCGCATAGCAT	AGGaGCAGATGCCCAGGGA	GAGAGAGGAGCAGATGCCCAGGGAAGGCGA	OPTC_p.E32G
TTTGACTCAGTATCTACATCTCG	CTaCTGTAGAGCCCACACC	CAAAACTACTGTAGAGCCCACACCTGGGAA	EML4_p.T486A
TTTGGATCATCAGCATGTGTCGC	CTaCTGTAGAGCCCACACC	CAAAACTACTGTAGAGCCCACACCTGGGAA	EML4_p.T486A
TTTGCTCATCATGTCGCATCGTC	GAGaCCGAGGTGGGCGCCA	GCGGGGAGACCGAGGTGGGCGCCACGGCAG	WDR34_p.T333A
TTTGGTAGTCATCTAGCTATATC	CATGaCTGCGCCGGTGTAC	ACACGCATGACTGCGCCGGTGTACTGGACG	SLC6A9_p.D155G
TTTGCTAGTATCATATATAGTAT	CGCaTGGAGCTGCGCTCAG	CCCCGCGCATGGAGCTGCGCTCAGTGGGCG	BCR_p.M23V
TTTGCTATGCATCATCTAGTATA	CGCaTGGAGCTGCGCTCAG	CCCCGCGCATGGAGCTGCGCTCAGTGGGCG	BCR_p.M23V
TTTGTCATCACGAGTCATCATCG	CGCaTGGAGCTGCGCTCAG	CCCCGCGCATGGAGCTGCGCTCAGTGGGCG	BCR_p.M23V
TTTGACACTATCATACGTCTAGT	CGCaTGGAGCTGCGCTCAG	CCCCGCGCATGGAGCTGCGCTCAGTGGGCG	BCR_p.M23V
TTTGGTGCATCATATCTATCGAC	GTCCCaCGCAGCCCAGTCC	CCAGAGTCCCACGCAGCCCAGTCCGGGGCC	EP400_p.T137A
TTTGCTCTATCAGTCACTATAGT	TCCaTGGACCGCGCGGCCG	CCCCGTCCATGGACCGCGCGGCCGTGGCGA	NT5C3_p.M6V
TTTGAGTCTATCGTCTATCAGCG	GACCaAAGTACAACTTCCA	AAGTAGACCAAAGTACAACTTCCATGGCAA	IKBIP_p.Q159R
TTTGTATATCATCGTCATCACAC	AGAaGAGAGATGTGTCACT	GTTTCAGAAGAGAGATGTGTCACTCGGCAC	TNKS1BP1_p.K932R
TTTGTACATCATCATCGACTATC	CTaCCTGCTGTACCACACC	AGGGTCTACCTGCTGTACCACACCTGGAGC	DOLPP1_p.Y156C
TTTGCTCATCGCACTCACGTCAC	ACGGTaCCATGGACCCCGC	GCACGACGGTACCATGGACCCCGCTGGCAC	SARDH_p.T210A
TTTGATCTCACAGATCTATAGCT	AGTTCaCTGCGGCCTTTGT	CTCAGAGTTCACTGCGGCCTTTGTGGGCCG	IPO9_p.T759A
TTTGAGTAGTCATCGTCTAGTAG	GGGGaGAGGAAAGCGGTCC	GCAGTGGGGAGAGGAAAGCGGTCCAGGCCG	ROBO3_p.E1301G
TTTGCGTCGCATCATATATCAGT	TTCCaGTTGGAGCAGCTGC	GTCGCTTCCAGTTGGAGCAGCTGCAGGCGC	IZUMO2_p.Q45R
TTTGTGATATCGTCATCTATCGA	ACTaCACCACGGAAGGCTG	TTCTTACTACACCACGGAAGGCTGGGGAGC	TNS4_p.Y43C
TTTGGATCAGTATCTAGTACGTC	TTTaTGGTTGCCTGTACGC	AGCGTTTTATGGTTGCCTGTACGCAGGCTG	DIP2C_p.Y1045C
TTTGCTCATCGTCATCTCATACA	CCTGGaCACGGTGCCCCTG	ACAGACCTGGACACGGTGCCCCTGAGGTGC	PSD_p.D289G
TTTGTCTCAGAGAGCATCTATCG	CGCaACCTGCGCGCCGCGG	CCGGCCGCAACCTGCGCGCCGCGGGGGGCG	C9ORF66_p.N114D
TTTGATATATCGTATCTCATAGT	GAAaTCGTGCGCGACATCA	AGCGGGAAATCGTGCGCGACATCAAGGAGA	ACTG1_p.I208V
TTTGTCACATCACATACGTCATC	CGGCCaCAGCTGGGGCCGG	CGCGGCGGCCACAGCTGGGGCCGGTGGCTC	TAF8_p.T7A
TTTGGAGTGTGTCATCGTATCTC	GCTGTaCGCCCGGCGCCGG	CTGAGGCTGTACGCCCGGCGCCGGCGGCCC	RARG_p.Y353C
TTTGGTATATCAGCATCATGTAG	CTTCAaTCGGGCTGGCACG	CAAGCCTTCAATCGGGCTGGCACGGGGCCC	DSCAML1_p.N1130S
TTTGAGTATCGTCTATAGCATCT	CTGaCACCCTGGTGAAGAC	GGGCACTGACACCCTGGTGAAGACTGGGCA	ITGAD_p.D184G
TTTGATGTCATCACTCGTCATAC	AGCaCCATCCAGTGCCCCG	GAGCAAGCACCATCCAGTGCCCCGAGGGAT	PTPRD_p.A406A
TTTGGCAGTCAGTCAGTCTCTAT	GGCTaCTGCAGAGCTGGGC	AGAACGGCTACTGCAGAGCTGGGCTGGACG	EPHB1_p.T29A
TTTGCTAGCATCTACATCTACGA	GGCTaCTGCAGAGCTGGGC	AGAACGGCTACTGCAGAGCTGGGCTGGACG	EPHB1_p.T29A
TTTGATAGTATCTACAGTCTATG	CTGCaGGCCGGTGCCCCGC	GCCCCCTGCAGGCCGGTGCCCCGCGGGTGA	PVRL4_p.001
TTTGGTATCAGTCACATAGTCTG	AAGGaCGGCACGTGGACCA	TGTGCAAGGACGGCACGTGGACCACGGTGC	SOLH_p.D590G
TTTGTCATACTCATCGTCAGCTA	AAGaTCAGCAACGTGGGAG	CCCCCAAGATCAGCAACGTGGGAGAGGACT	MYBPC3_p.I780V
TTTGGCATGTCACATAGTCTCTA	CCGCCaCTTTGTGGGCCTG	CTGACCCGCCACTTTGTGGGCCTGCGGGTC	KCNC1_p.H327R
TTTGACAGTATATATCAGAGATA	GCAaTGACCGCATCAGGGT	ATTGAGCAATGACCGCATCAGGGTGGGGGA	AGT_p.N416S
TTTGATATCATACGCATCTACGC	GCGTCaAGTGCGTGCTGGT	GCGCGGCGTCAAGTGCGTGCTGGTCGGCGA	RHOU_p.K51E
TTTGGTGTGTCGTCATCTATCGA	CAGaCTTCCTCTTCCTCAG	CGCAGCAGACTTCCTCTTCCTCAGCGGCCG	MRGPRX1_p.D72G
TTTGCACAGTGTATATAGCATCT	TAGCaTTCCATGGTTCCTC	GACAGTAGCATTCCATGGTTCCTCCGGGTT	ZNF410_p.I162V
TTTGTCTGTATCATATCGCATCA	TAGGGaGTGGAATGACCCC	CTCTATAGGGAGTGGAATGACCCCAGGGGC	POLR2A_p.S1537G
TTTGCTGTCAGTCACTGTATCTC	TTGCaGTGGAGCCTCCTAG	ACCCTTTGCAGTGGAGCCTCCTAGTGGCCG	TMEM141_p.Q61R
TTTGTGAGTACAGCAGTAGTACA	CCaCCTGCGCACCAGGGGC	CCAGTCCACCTGCGCACCAGGGGCAGGACA	C6ORF223_p.H96R
TTTGATCTATCACAGTATCATCA	CCTaCGCCGTCCACCTTGA	GGAAGCCTACGCCGTCCACCTTGAAGGCAG	COL4A1_p.T1289A
TTTGGTCTGTCATATGTCATAGC	GGGaTGTCGGGGCTGCTCA	GGATCGGGATGTCGGGGCTGCTCACGGACC	GK5_p.M1V
TTTGATGTGTCATCAGCAGTATA	CAaTGAGTACATGCCCAGC	AGCTGCAATGAGTACATGCCCAGCCGGATC	PIWIL1_p.N690S
TTTGAGAGTCATCTAGTACATAC	GAACaCAGCTTGTTGTGCC	CCCTCGAACACAGCTTGTTGTGCCCGGTGT	LRRC4C_p.T324A
TTTGCAGCATCATATCTATCATC	TACTaTTCTGTACAAAACT	CGAAATACTATTCTGTACAAAACTTGGGAA	C12ORF26_p.Y115C
TTTGTCACTGTATCTATAGCATA	CGCaGCACTCTGACGGGCG	TTGAACGCAGCACTCTGACGGGCGTGGATC	LRP2_p.S2578G
TTTGGTAGTCAGTCAGTATCGTG	ATCCaGTGTGCAAAAGGTA	GGACCATCCAGTGTGCAAAAGGTACGGCGG	C21ORF124_p.Q272R
TTTGCTCATCACTATATCTATCG	ATCCaGTGTGCAAAAGGTA	GGACCATCCAGTGTGCAAAAGGTACGGCGG	C21ORF124_p.Q272R
TTTGCATCACGTCATCTATACAG	GAAGaGTTAACCCGGGACT	ACCACGAAGAGTTAACCCGGGACTTGGAGA	CDKN1B_p.E40G
TTTGACATCATCTCTAGCAGTAG	GACaCCCGGGGTCAAGCAG	TCGTGGACACCCGGGGTCAAGCAGAGGAGG	FLG_p.H1492R
TTTGCATCAGTACAGCATCATAC	CCCaGTCACCAGCAATGGT	AACCGCCCAGTCACCAGCAATGGTCGGAAG	TAF3_p.Q290R
TTTGCGTCATCTAGTCTCACTAT	CGGCaGCTGGCAGCCGAGC	GGAAGCGGCAGCTGGCAGCCGAGCTGGAGG	HMX1_p.Q261R
TTTGCGTCATCGTCAGTCTCGCG	CACaTCAACAAGTCGCTGT	CGCAGCACATCAACAAGTCGCTGTCGGCTC	KIFC3_p.I697V
TTTGTGTGTCAGTATATATATCA	CTTaTGTCCAGAAATGAAG	TGATGCTTATGTCCAGAAATGAAGAGGCCA	FXR1_p.M199V
TTTGCTCGAGTCATCTAGTCAGA	CTGCaGCTGTGGCCGCCCC	GGGTCCTGCAGCTGTGGCCGCCCCCGGCGC	KIF26A_p.Q345R
TTTGATATAGTATCGCATCGTCT	CCCaCAAAGTTCCTGGCCG	ATTCACCCACAAAGTTCCTGGCCGTGGAGG	MYBL1_p.T338A
TTTGATCATGTATAGTATCGCTA	CGTCaGCTCCAGGCGGTCC	GGCACCGTCAGCTCCAGGCGGTCCTGGTGG	PCSK9_p.S5G
TTTGTGTGTATCATCTCAGATCG	CACaTGGTCCCGCTGGTAG	TCGACCACATGGTCCCGCTGGTAGAGGAGA	C7ORF26_p.M322V
TTTGATCATATCGCGTAGCATCT	CCCCaCCACGCCTGGGACG	CTGGCCCCCACCACGCCTGGGACGAGGAGC	NCOR2_p.H2492R
TTTGCGCATCTCATAGCATCGTC	AGAGCaTCCACGGCTCCGG	GCGACAGAGCATCCACGGCTCCGGCGGCCC	PCDHAC2_p.H13R
TTTGATGTCATCATCGTCAGAGT	CCACaGAGTGCAGAGCTCC	TGGAGCCACAGAGTGCAGAGCTCCTGGCCC	NINL_p.Q536R
TTTGAGCTATATCATCTATCGTC	GGCCaGAGCTCCCAGCCCC	TGTGTGGCCAGAGCTCCCAGCCCCTGGTGA	TMEM176B_p.Q235R
TTTGTGATATCAGAGTATATCTA	CCCAaAAAGGTTGGGATGG	TTGCGCCCAAAAAGGTTGGGATGGAGGTCC	BRD4_p.K1191R
TTTGTGTATCAGTCACGTCTACA	CCCAaAAAGGTTGGGATGG	TTGCGCCCAAAAAGGTTGGGATGGAGGTCC	BRD4_p.K1191R
TTTGCGAGAGCATCATCTCAGAT	CTATCaTCAAAGTATACGG	GTGCGCTATCATCAAAGTATACGGTGGAAA	NAALAD2_p.H44R
TTTGTGATCAGCACTAGATCTAT	CCCaGCCCCCTGCACGCCG	CGTACCCCAGCCCCCTGCACGCCGTGGCTC	DACT2_p.S277G
TTTGGTGTACTCACGTCTATCTC	CAGaCAGGCGAGAAGTACG	AGAATCAGACAGGCGAGAAGTACGAGGGGA	SLTM_p.D842G
TTTGGCAGTCACTCTAGCTATCT	GCTCTaAGTCAGCCAAAAG	CACCCGCTCTAAGTCAGCCAAAAGTGGGTG	IPO9_p.K900E
TTTGCACAGATCATATCATCGCG	TCACaGTGTCTTGGGCCGC	CGGAGTCACAGTGTCTTGGGCCGCCGGAAG	HLA-F_p.S380G
TTTGGATCACAGTAGTCATCTAT	CTCaGCCGCGACCCCTCCA	ACACGCTCAGCCGCGACCCCTCCAAGGGCA	CACNG8_p.S310G
TTTGTATATCATCATCACGTCAC	CTGTaCAGCAGCCTGTGGC	AAGCCCTGTACAGCAGCCTGTGGCAGGGGT	ADAMTSL3_p.T1610A
TTTGCGTCTACATCTAGATCTAC	CGCGaCCTAGATGGCTTCC	CGCACCGCGACCTAGATGGCTTCCTGGCGC	SLC4A11_p.D129G
TTTGATACATCATCACGAGTCTC	ATGTCaGCAAGACGCAGGT	CCAGAATGTCAGCAAGACGCAGGTGGGCGT	ZNF592_p.S885G
TTTGCTGTATCATCACAGAGCTA	TGGATaGAGCAGGAGGGGC	CGCCGTGGATAGAGCAGGAGGGGCCGGAGT	HLA-A_p.I76M
TTTGGTGTGTATCACATACTCAG	TGGATaGAGCAGGAGGGGC	CGCCGTGGATAGAGCAGGAGGGGCCGGAGT	HLA-A_p.I76M
TTTGTAGTATATATCTCTATCGT	CCTaCGAATGTAAAGACTG	GAAGCCCTACGAATGTAAAGACTGTGGGAA	ZNF331_p.Y187C
TTTGATGTGTCAGTGTGTATAGT	AGaCTCTGGCTGGCCACGA	GCTGAAGACTCTGGCTGGCCACGAAGGCAA	PRPF4_p.T487A
TTTGGATCAGACATCATCTCAGA	ACCaTTCACGCCGACAGCG	CCGAGACCATTCACGCCGACAGCGTGGCCA	SEPX1_p.I50V
TTTGTGTATCGCATGTCATCGCG	GCCGaCTGCCTGCTCAGCA	CCGGTGCCGACTGCCTGCTCAGCAAGGAGC	BEND3_p.D552G
TTTGCAGAGTCATCGTATCAGAC	TGGACaCCAAGGTGACCAC	GCCATTGGACACCAAGGTGACCACTGGAAG	NRP1_p.H758R
TTTGCGATCTCAGTATCATCGTA	CCCCaCCTAGAGAAACAGC	AGGCGCCCCACCTAGAGAAACAGCCGGCAG	AKIP1_p.H58R
TTTGCTCATCATCACGATCTATC	TGCaGTCAGGGTGTCCGTG	AGTTCTGCAGTCAGGGTGTCCGTGAGGGCC	C11ORF2_p.S486G
TTTGTACATCGCATCATCGCGTC	GGGCTaCGCGGAGAAGGTG	ATGAGGGGCTACGCGGAGAAGGTGAGGAGC	MRPL17_p.Y55C
TTTGATCTCAGAGCATCGTCATA	CTGGaTGAGGCTGAGCAGC	TCCGTCTGGATGAGGCTGAGCAGCTGGCGC	MYH4_p.D1802G
TTTGTAGTCAGTCTACGAGTATA	GCGGaGACTCTGATGGCCA	TGCTCGCGGAGACTCTGATGGCCAAGGAGT	FAM86B2_p.E98G
TTTGTCTCAGTGTATCGTCTAGA	ACTaCGCCAAGGAGGTGGC	CCAGAACTACGCCAAGGAGGTGGCAGGGGT	RRBP1_p.Y1219C
TTTGTGTCACTAGTAGCATCATC	TACaGAAAGGTGCCCATCC	CCTCCTACAGAAAGGTGCCCATCCTGGTGG	PTGES2_p.R146G
TTTGTGTCAGCATGTGTATAGTA	GGCaAGAGCTGGGGCACAG	TGCTGGGCAAGAGCTGGGGCACAGGGGCTG	FAM108A1_p.K144E
TTTGGTCTATCATACGTCACTAC	GGCaAGAGCTGGGGCACAG	TGCTGGGCAAGAGCTGGGGCACAGGGGCTG	FAM108A1_p.K144E
TTTGGAGTCATCACGAGTCATCA	CGGaGCAGCTGGTCCAGGA	TCCCTCGGAGCAGCTGGTCCAGGATGGGGC	C9ORF48_p.E1069G
TTTGATATATATCATCTCATCGA	GCTCCaGCTGTGGGGGTTG	CTGTGGCTCCAGCTGTGGGGGTTGTGGCTC	KRTAP5-2_p.S20G
TTTGATGCATCACTATCATAGCG	AGGGCaAAGTGCAATTGCT	AAATCAGGGCAAAGTGCAATTGCTGGGGAA	WDR11_p.Q433R
TTTGATACATCATCTAGTATATG	GCGaCCTTCTAAACACCGG	TGCACGCGACCTTCTAAACACCGGGGGCAT	PKP2_p.D812G
TTTGTATGTATCTATCACATACA	TCCaGTCGTGCATTTCCGA	CGAATTCCAGTCGTGCATTTCCGATGGCAT	SH3PXD2A_p.Q432R
TTTGCAGTATCAGATCTACATCG	AACaTCAACATCTGTCTGA	CAGGCAACATCAACATCTGTCTGATGGGGG	MCM7_p.I199V
TTTGCAGTATCAGTATCAGAGTA	CAGAaGTAGGAACCAGTTC	ACCTCCAGAAGTAGGAACCAGTTCAGGTAA	MYO18B_p.K2567R
TTTGGACAGTCAGTCTATACGCA	AGCCaCCCCAACCCGCGAA	TCTGCAGCCACCCCAACCCGCGAAAGGTAC	SRM_p.H91R
TTTGAGCATCATCTGTATCATAC	AAGaGCTGTCGGTCATTGA	GGTCAAAGAGCTGTCGGTCATTGATGGCCG	DAAM2_p.E669G
TTTGGTCGCACTATCTACTATCG	AGGaGCTCCAAAAGTAGGG	CACATAGGAGCTCCAAAAGTAGGGAGGCCT	ZNF419_p.S157G
TTTGGTCATCATCTACAGTATAG	CACCaGCTGCGATCTGCTC	CGCTTCACCAGCTGCGATCTGCTCTGGCGC	FBXW4_p.S63G
TTTGTCATCATACAGAGCATAGT	CTGTaCCTAACCCTGGAGA	ATGACCTGTACCTAACCCTGGAGAAGGGGG	DOCK3_p.Y425C
TTTGACAGATCGTATAGTATATA	ATGCaGTACAATAGCACGC	CCTTCATGCAGTACAATAGCACGCGGGCGG	HS6ST1_p.Q318R
TTTGATAGTATCATCACTAGCGT	TGGaCAGTTCTTCAGGCTT	GCGAGTGGACAGTTCTTCAGGCTTGGGTGA	NRXN1_p.D1161G
TTTGATGTCAGTAGTCAGCAGTC	TGGaCAGTTCTTCAGGCTT	GCGAGTGGACAGTTCTTCAGGCTTGGGTGA	NRXN1_p.D1161G
TTTGATGATATCAGTATCATATC	CGCaGGCTCCTGCAGCAGG	TCCCGCGCAGGCTCCTGCAGCAGGCGGCGC	RARRES1_p.R57G
TTTGCTCGTCATCACTCACGTCA	ACCTaCTACCGCATCTTCA	GCATCACCTACTACCGCATCTTCAAGGTCG	HRH2_p.Y202C
TTTGACATACATCTCACGAGTAT	TGTaCAATGTGAGTAGAGC	TGTGCTGTACAATGTGAGTAGAGCTGGTGG	CACNA1E_p.Y316C
TTTGGTCATCACTCACTACGTAT	CTGaGCTACCTGAGCGTAA	GCCACCTGAGCTACCTGAGCGTAAGGGGCG	LGALS2_p.S115G
TTTGGTCATCTCATCACAGCGTC	GCTTCaCTGTGCTGGTCAA	CAATGGCTTCACTGTGCTGGTCAACGGTGG	MAP1S_p.T262A
TTTGCTAGTCAGAGCTAGTATCA	TCTaCAGCCGCATGAAGGT	CACCGTCTACAGCCGCATGAAGGTGGGGAG	TRIM50_p.Y129C
TTTGAGTCATCTAGTCAGAGCAT	TTCCaCAGGGCCTGCCGCC	GGCGCTTCCACAGGGCCTGCCGCCTGGTGC	CYP4F12_p.H257R
TTTGCGACATCATCATCGATCTC	TCACCaCGGTGAGTGGCCT	ATTCATCACCACGGTGAGTGGCCTGGGGCA	ERGIC1_p.T255A
TTTGGCATATAGTATCTAGTATA	ATCaGCACAGCCCGGGCCA	AGAACATCAGCACAGCCCGGGCCAAGGTGA	RUNDC3A_p.S119G
TTTGTGATCGTCATACGTCTAGC	CTCCaGAGACCACAGAGCT	TGCCTCTCCAGAGACCACAGAGCTGGGCAG	ASTN2_p.001
TTTGGTGTACGTCTATCAGCAGC	CGATTaCTACAAGCTGCTG	GCCGCCGATTACTACAAGCTGCTGGGGAAC	ROR2_p.Y645C
TTTGTATCTAGTATATCATCGCA	CGATTaCTACAAGCTGCTG	GCCGCCGATTACTACAAGCTGCTGGGGAAC	ROR2_p.Y645C
TTTGGTCTATCTCTACATCATAT	TTGGTaTGTCCCACTGCTC	TCAAGTTGGTATGTCCCACTGCTCTGGGCC	LIMK2_p.001
TTTGTGTACATCACGTCATACTC	GCGCaCGACCCGCATGTCC	GGCCTGCGCACGACCCGCATGTCCTGGCCC	PDE4A_p.T81A
TTTGCGATCGCATATCATCGACG	GACGaGGACCTGGCTGAGG	AGCACGACGAGGACCTGGCTGAGGAGGAGG	MKNK2_p.E411G
TTTGCTAGTCTCATCGTCATACA	GATGaCGAGCCAGAGTACG	CAGGCGATGACGAGCCAGAGTACGAGGTGA	DNMT3A_p.D280G
TTTGTGTCATGTATCGCATCGCT	CTaAGTTTGGGGATTGGAG	AAAGCCTAAGTTTGGGGATTGGAGTGGGGC	KIAA0467_p.K1108E
TTTGTCTATCATCTAGTATCACA	CTaAGTTTGGGGATTGGAG	AAAGCCTAAGTTTGGGGATTGGAGTGGGGC	KIAA0467_p.K1108E
TTTGCGTCATCACTATCATACAT	CTGCaCAAGTCCCTGCAAC	ACGTCCTGCACAAGTCCCTGCAACTGGACG	RNF207_p.H469R
TTTGCATACATCATAGCTCTATA	ACCGaGCGCTTGATGTGCG	CCATCACCGAGCGCTTGATGTGCGCGGAGA	CFD_p.E191G
TTTGATAGTATATCACAGAGTAC	ACCGaGCGCTTGATGTGCG	CCATCACCGAGCGCTTGATGTGCGCGGAGA	CFD_p.E191G
TTTGCAGAGTGTATATATCGCTA	CCAAGaGAAGAAGCCCATC	GCTACCCAAGAGAAGAAGCCCATCAGGCGC	TMEM200A_p.E36G
TTTGTGTGTGTACAGCATATCTC	CGCGaCGCCGAGGAGGCGC	AGCACCGCGACGCCGAGGAGGCGCTGGACA	KCNC2_p.D161G
TTTGATCACTCATACGTCAGTCA	TGCCaCCTTACCCCAGTCA	ACTGGTGCCACCTTACCCCAGTCAAGGTAC	TFDP2_p.T321A
TTTGCACATACGTCATCATCACT	GGCGCaGAAAGGTGGAGGC	GCAGCGGCGCAGAAAGGTGGAGGCCGGGAG	PCNT_p.R10G
TTTGCTATCTATCATACATACGA	GGCGCaGAAAGGTGGAGGC	GCAGCGGCGCAGAAAGGTGGAGGCCGGGAG	PCNT_p.R10G
TTTGTCATCGTATCTCATAGTCA	TTTCTaGTGCCACAGCAGG	TTCCCTTTCTAGTGCCACAGCAGGGGGTAG	AHNAK2_p.S21G
TTTGCAGTGTGTCTATCTACAGT	CTGGaCTGCCCAGCAGCTG	TCCGCCTGGACTGCCCAGCAGCTGTGGTTG	NRIP3_p.D181G
TTTGATCATCTCACATCATCTAT	TGGaGCCATGAGGTCATCT	CAGCCTGGAGCCATGAGGTCATCTTGGAGT	ABHD15_p.S404G
TTTGTGTATCGCATCGCATCATG	ACCaTCCAGCCGCAGGGCG	AGTTCACCATCCAGCCGCAGGGCGCGGGGG	ADAMTS8_p.I135V
TTTGCGTGTATAGCATCTATCGT	CTaCTGGTGCCGGGAAGAC	CCAGTCTACTGGTGCCGGGAAGACTGGCCA	NPFFR2_p.Y306C
TTTGGCACATATCATATCGTATC	AAACCaTCTCGGACCCGGA	CAAAAAAACCATCTCGGACCCGGAGGGCTT	ARHGEF7_p.I24V
TTTGTACAGAGCAGTAGTAGTAC	AAACCaTCTCGGACCCGGA	CAAAAAAACCATCTCGGACCCGGAGGGCTT	ARHGEF7_p.I24V
TTTGTCGTCTACAGTCTATCGTC	TGGaGTGTGAGGAGTGTGG	ACGGCTGGAGTGTGAGGAGTGTGGCGGCCT	RET_p.E527G
TTTGAGTCAGATCACTACAGTCA	GAAaCGACTGCCCCTCCTC	AGAGTGAAACGACTGCCCCTCCTCCGGCCC	KLF5_p.T175A
TTTGGTGTACGTCTAGCAGTATC	GCCaGGCCCCCAGGGAGCG	AGGGCGCCAGGCCCCCAGGGAGCGTGGAGG	DACT2_p.R197G
TTTGGCATCTGCATATATATCAT	GCCaGGCCCCCAGGGAGCG	AGGGCGCCAGGCCCCCAGGGAGCGTGGAGG	DACT2_p.R197G
TTTGATCATCTATCTAGTACTAT	GGaCTGTGGCAAGACCTTC	GCAGAGGACTGTGGCAAGACCTTCCGGTGC	ATMIN_p.D186G
TTTGGTACATCATCATAGTCTCT	CCCCCaACCGGCGCTACCC	CCAGTCCCCCAACCGGCGCTACCCAGGTCC	ELAVL4_p.N230D
TTTGCATCATATCATCAGCTATC	GGCaGCAGCAGCAGTGAGC	GCAGCGGCAGCAGCAGCAGTGAGCTGGAGG	CSF1R_p.S937G
TTTGCATCTAGTCAGTACGTATA	ACTaCTCCCTGCGACCCAG	GTACAACTACTCCCTGCGACCCAGCGGAAG	AARS2_p.Y518C
TTTGCTCTATCATATATAGCATC	GCTGaCACGGAGCCGTGTG	GCGAAGCTGACACGGAGCCGTGTGTGGACG	SLC22A11_p.D109G
TTTGTGTCACTATATCGCTATCT	GCTGaCACGGAGCCGTGTG	GCGAAGCTGACACGGAGCCGTGTGTGGACG	SLC22A11_p.D109G
TTTGTGATCATCACAGCTAGTCT	GGAGCaCCTGGCGCAGTAT	ATGGGGGAGCACCTGGCGCAGTATTGGAAG	MORC2_p.H384R
TTTGACATACGTCAGTCAGCTAG	TGACTaGGCCGCACCTCCG	TATGATGACTAGGCCGCACCTCCGGGGAGG	C19ORF12_p.*153W
TTTGTGTATATCAGTATCTCAGC	TGACTaGGCCGCACCTCCG	TATGATGACTAGGCCGCACCTCCGGGGAGG	C19ORF12_p.*153W
TTTGACATCATACTCAGCATATG	CGTGCaGCGCGAGGAGCTG	ACCTGCGTGCAGCGCGAGGAGCTGTGGCCC	FAM83E_p.Q51R
TTTGTCAGCATCGCTATATCATA	GAGGaGCAGGTACACGTGG	CTGCTGAGGAGCAGGTACACGTGGTGGGGG	CLEC4M_p.E244G
TTTGTCTCAGTATCATATATCTG	CGAaTCGCGCAGCAGCTCC	GGGGGCGAATCGCGCAGCAGCTCCCGGGGT	RBM15_p.E139E
TTTGCACATATCATCACTAGCGA	CGAaTCGCGCAGCAGCTCC	GGGGGCGAATCGCGCAGCAGCTCCCGGGGT	RBM15_p.E139E
TTTGTGTCATCGACTAGTACGTA	CGAaTCGCGCAGCAGCTCC	GGGGGCGAATCGCGCAGCAGCTCCCGGGGT	RBM15_p.E139E
TTTGTACACAGTAGCATATATAG	CGAaTCGCGCAGCAGCTCC	GGGGGCGAATCGCGCAGCAGCTCCCGGGGT	RBM15_p.E139E
TTTGCTCATGTGTATCGTATATA	TTGCTaTTTATTCCTCGTC	GGGCATTGCTATTTATTCCTCGTCGGGCTC	HSP90AB1_p.L333L
TTTGAGTCATGTCATCATCATCG	AAGaTGCAGCTTCGGGAGT	TACGGAAGATGCAGCTTCGGGAGTTGGCTC	SF1_p.M242V
TTTGTAGTCAGTCAGTAGTCAGC	GCCaTGAGCTACAGCAGGC	GCTGGGCCATGAGCTACAGCAGGCTGGGCT	NUMA1_p.H1657R
TTTGCTCAGCATCTCTACGAGTC	AGAGaCAGAGAAGTCGCGC	TTCCGAGAGACAGAGAAGTCGCGCTGGTCA	ALKBH7_p.T76A
TTTGTGCACTCGTCATCGCAGTC	GAGCaGTTCCTGTCCACCA	CCTCTGAGCAGTTCCTGTCCACCATGGTGC	DUOX1_p.Q328R
TTTGTCATCTCAGTGTGTATCTA	GCTaCGAGGACGTGGCACG	GGTGCGCTACGAGGACGTGGCACGCGGGCC	CHST3_p.Y371C
TTTGACGTCATCTACATCATACA	CCCTGaCAGTTCCCTTCCA	CGTTCCCCTGACAGTTCCCTTCCAAGGGTG	PDZRN4_p.D497G
TTTGTGTATCGTCTATCTACTCA	CCCaTGACAGCAGGTGAGC	TCGTGCCCATGACAGCAGGTGAGCAGGACG	PPIE_p.M167V
TTTGAGTGCATCTAGTAGTCTAT	ATGAaCATTCACCTGGGCA	CAGTCATGAACATTCACCTGGGCAAGGCCG	TSHZ3_p.N547S
TTTGTAGTGTGTGTATCAGCTAT	ACCaTGCGGGAGGTGAGGC	TCAAGACCATGCGGGAGGTGAGGCGGGCTC	FBXW5_p.M453V
TTTGAGTATCTATATAGTATATC	GCCTGaCAATGAGCAGCAG	TGGCAGCCTGACAATGAGCAGCAGTGGCAG	EDC4_p.T666A
TTTGTCATGTCATACGTCACGTC	AGCCTaCCTGGCTGACGAG	GAGGCAGCCTACCTGGCTGACGAGCGGGAG	SLC4A2_p.Y590C
TTTGTGTGTGTCTAGAGCATCTA	ACTCaGGAAGCTGAGCCTG	GGGAGACTCAGGAAGCTGAGCCTGGGGCAG	TNS3_p.R773G
TTTGGCAGTGTATCAGATCATCA	GGGCaACCGGACCCTGGTC	CCCTCGGGCAACCGGACCCTGGTCAGGAGG	ANO1_p.N48D
TTTGTATAGTCATCATACTAGTC	GGGCaACCGGACCCTGGTC	CCCTCGGGCAACCGGACCCTGGTCAGGAGG	ANO1_p.N48D
TTTGCGCATCGCATCGTCATACT	GGaGCTGCAACTGCACCCC	TCCCCGGAGCTGCAACTGCACCCCAGGCTG	NPB_p.E73G
TTTGTGAGTAGTACAGTATCGCG	GATGGaGAGGTAGAGACTC	GTACTGATGGAGAGGTAGAGACTCAGGTAT	TPR_p.G1879G
TTTGCTATCAGATCGTCATCACG	TGCCaGTGTGGGGGGCAGT	GGAGGTGCCAGTGTGGGGGGCAGTGGGCTG	ZBTB4_p.S683G
TTTGTCGCATCATCACTAGCATG	CTGGaCACCACGGCCGGCG	GCACACTGGACACCACGGCCGGCGAGGTGG	PHLPP1_p.D224G
TTTGCAGAGTGTGTCTAGTATAC	GCCaTGGTGCACAGGGATG	TTGGTGCCATGGTGCACAGGGATGAGGCCT	GRAMD4_p.M551V
TTTGCTCACATCATGTATCGTAT	GTTTaTTATCCAGTGGAAC	GGAGGGTTTATTATCCAGTGGAACGGGAAC	ADAMTS12_p.I758V
TTTGATATCGTCACTATATCATA	GCGGCaGCAGCTCCGGCGG	CGGCGGCGGCAGCAGCTCCGGCGGCGGATA	KRT10_p.S551G
TTTGTGCTCATCATCACGACTAT	GCCCaTGATCCTCATCGGT	AACCGGCCCATGATCCTCATCGGTGGGTGA	MOCS1_p.M380V
TTTGTATAGTATCAGCACATACG	TCTaCAATGGGAAGGTAGC	CGAGATCTACAATGGGAAGGTAGCTGGCAG	KIF2C_p.Y405C
TTTGGTCATGTCAGCATCTATGA	TCCaGTCAGGACACTGGTG	CGTGCTCCAGTCAGGACACTGGTGAGGACT	TAOK2_p.Q246R
TTTGATCAGTATATATCAGTAGA	CAaGGGCCAAGCTGGTCCC	CCTGACAAGGGCCAAGCTGGTCCCTGGGGC	MAP3K13_p.K571R
TTTGACAGCATCTACGTATCTAT	ACCAaCGGACTCTGAGCCC	TCGACACCAACGGACTCTGAGCCCCGGACT	CBFA2T2_p.N602S
TTTGGAGTCTATCATCGCTATAC	AAGGaGATCTGCTACGAGG	CGGTGAAGGAGATCTGCTACGAGGTGGCCC	KIF1C_p.E754G
TTTGTGTATATCTCACATCACTA	GAGGaGGTGGTGCGGCGGG	TGCAGGAGGAGGTGGTGCGGCGGGAGGAGG	PLEC_p.E1400G
TTTGTATCAGTCACTATCATACT	GAGGaGGTGGTGCGGCGGG	TGCAGGAGGAGGTGGTGCGGCGGGAGGAGG	PLEC_p.E1400G
TTTGATCAGTGTGTGTCGTCATC	ATGGAaAAGGAGAACCCAA	ACTAGATGGAAAAGGAGAACCCAAAGGGGC	IQGAP2_p.K1467E
TTTGTACAGCATCTATGATCGTC	ATGGAaAAGGAGAACCCAA	ACTAGATGGAAAAGGAGAACCCAAAGGGGC	IQGAP2_p.K1467E
TTTGAGTCATCATCGAGTCATCT	GGCCaCCCAGTTTGAGAAC	CAGCTGGCCACCCAGTTTGAGAACTGGTAT	GUSB_p.T523A
TTTGGAGAGCATCTCAGTATCAT	GCCaCTGAGACCGGTGAGG	GCCTGGCCACTGAGACCGGTGAGGGGGAGG	DIDO1_p.T1568A
TTTGAGTATCAGTCAGTCTCATC	CAGaGCGCCATCTACCACA	GGGGCCAGAGCGCCATCTACCACATGGTGC	TTC21A_p.S1063G
TTTGGCTATCAGCTAGTATCAGC	GCCaGGCATCCCTCGACTG	CCAGGGCCAGGCATCCCTCGACTGCGGCCA	PLXNC1_p.Q278R
TTTGATATCATGTGTATCTATAG	TCGCTaCTGCAATTTAGAG	AAAATTCGCTACTGCAATTTAGAGGGGCCA	LY6K_p.Y178C
TTTGGTCAGTATAGTATCATCGC	ACTaCCCACACCGTGGGAG	ACAGCACTACCCACACCGTGGGAGTGGGGG	SETD5_p.Y1414C
TTTGTCTCACATAGTCAGTAGCA	TGCaGTGGGAACCTGCTGC	TCTCATGCAGTGGGAACCTGCTGCAGGTCC	STAB2_p.S2311G
TTTGAGATCTATCATCATCATGT	GATTaCCCGGCCTATGCAC	CCAAAGATTACCCGGCCTATGCACTGGCTG	SLC6A20_p.Y514C
TTTGTATCGAGTAGCATCTACAT	CCTGCaCGCTCAAGGACAG	CCCCACCTGCACGCTCAAGGACAGCGGCGA	IGSF22_p.T1276A
TTTGAGAGAGAGCATCACTATCA	GAAGCaTGTCCGGTCACTC	CGAGAGAAGCATGTCCGGTCACTCCGGGCC	SAFB_p.M856V
TTTGCTGCATCTATCTCTACGAG	GGTGCaGCACTGCAATGAA	TCCCTGGTGCAGCACTGCAATGAATGGCAG	DNAH2_p.Q1026R
TTTGGACAGAGTATATCAGTCTA	CTCaCGGTGGGCTTCCTCG	GTCTGCTCACGGTGGGCTTCCTCGTGGCCT	GPR6_p.T144A
TTTGGTGTAGTACAGCATATCAT	CTGAaGCTTCGAGAGGAAG	AGATTCTGAAGCTTCGAGAGGAAGAGGAGG	CCDC135_p.K701R
TTTGCTAGTCTAGTATCTAGTAG	CTGAaGCTTCGAGAGGAAG	AGATTCTGAAGCTTCGAGAGGAAGAGGAGG	CCDC135_p.K701R
TTTGAGAGTCTCATCTACTATAT	CACCaCGCTCACCACGCTC	CTGCCCACCACGCTCACCACGCTCTGGTCC	SLC2A1_p.T60A
TTTGACATATCAGCACTACATCA	CAGCaGCTGCACAGATGCG	GTCCACAGCAGCTGCACAGATGCGAGGCTC	GPR113_p.S278G
TTTGCTACAGTATCATACGTCAC	ATCaTGGCGGGCATCCTCC	ACACCATCATGGCGGGCATCCTCCTGGGCA	TSPAN15_p.M234V
TTTGAGTCAGTCAGTAGTATAGC	CCGCaCGGGGCAGGAATGT	AACATCCGCACGGGGCAGGAATGTCGGGGT	PLEKHB2_p.T58A
TTTGCTCGTCACTCATCGTCTAG	GCAGaCACCTTCATGTTTG	CCGAAGCAGACACCTTCATGTTTGAGGGTG	CYP4F22_p.D330G
TTTGCACACAGTATCTCATATAG	TGGTGaTTGCGTCTGTGGT	TGTGGTGGTGATTGCGTCTGTGGTGGGATT	NTRK2_p.I439V
TTTGTCTCATCTACGTATCTATA	AGTGGaAAAACTTTGTGAT	GAAGAAGTGGAAAAACTTTGTGATCGGCTT	DNAJC2_p.E339G
TTTGTCATGTGTATCACTATCTG	CTCTaCTGTGCTCTGTGCA	GGCTGCTCTACTGTGCTCTGTGCAAGGTGG	ZNF385A_p.Y182C
TTTGCTACACTATCATAGCATAG	CTGCaGCCCTTCTGTACCC	GCTGCCTGCAGCCCTTCTGTACCCAGGACA	NOXO1_p.Q167R
TTTGGTACTCAGTATCGCTATCA	GATaACCACACAAAGGAGG	GCATCGATAACCACACAAAGGAGGTGGTGG	STK25_p.N40D
TTTGTGCAGTATCATCTAGTAGT	CTCaGCCAGGCCTTTGAGC	GCGGCCTCAGCCAGGCCTTTGAGCTGGACC	SNX18_p.S475G
TTTGCATAGTCAGCTAGTATCAT	CCTCaTCCAGGAGTCTGTG	AGGCTCCTCATCCAGGAGTCTGTGTGGGAT	ALDH16A1_p.I311V
TTTGATCTAGTCTATCACTAGTC	AGCaCTGCCTCGTCCACCT	CTGCCAGCACTGCCTCGTCCACCTTGGAGA	SMG7_p.H153R
TTTGTCTCATGATCAGTATCATC	AGCaCTGCCTCGTCCACCT	CTGCCAGCACTGCCTCGTCCACCTTGGAGA	SMG7_p.H153R
TTTGCATGTCATCATCGAGAGCG	GTAGCaCCCAGGTAAGGGT	GGAGCGTAGCACCCAGGTAAGGGTGGGTCC	TEX14_p.T138A
TTTGCTCATAGTATCTATCACTA	GAGCaGGCGCGGGCCGCGG	TCCTGGAGCAGGCGCGGGCCGCGGTGGACA	HLA-DRB1_p.Q99R
TTTGATCATCGTATCGCAGTAGC	CTGCaGGCGAAGGCCGACC	AGCTCCTGCAGGCGAAGGCCGACCTGGAGA	IQCE_p.Q423R
TTTGCACATCATCGTCTAGATCA	GTGCaTCCCGAATTGAGTG	CCCTTGTGCATCCCGAATTGAGTGAGGTCA	NCOA6_p.H1561R
TTTGGTATATCAGTCTAGAGTCT	GGGaGGCCTTGGTGAAACC	GGTGTGGGAGGCCTTGGTGAAACCAGGTAA	NLRP1_p.E1347G
TTTGCATAGTATCAGATCGTCAT	TGGaTGAATATGTTAAACT	AGATGTGGATGAATATGTTAAACTCGGCCA	RCN2_p.D52G
TTTGCAGTGTCGCATCTCTATCG	TCaGGGGACATTCTGGAGA	GCCTTTCAGGGGACATTCTGGAGAAGGTCA	EIF2B2_p.001
TTTGGTCAGATCACTACAGTCTC	GCTGCaGCAAAGTTTTCCC	GCGCGGCTGCAGCAAAGTTTTCCCGGGATT	RNASEH2A_p.Q154R
TTTGAGCATCACATATCATAGTC	CACaTCACCAACCACTACC	CTGAGCACATCACCAACCACTACCTGGGGC	DAB2IP_p.I228V
TTTGATACATCATACTCATCGAG	CACaGAACACCTGGGGCTG	GAAGGCACAGAACACCTGGGGCTGCGGGAA	LMNA_p.Q436R
TTTGGATCAGATCATCTATCGAC	CTTCGaTGACCTGCTGGCG	CTGGCCTTCGATGACCTGCTGGCGGGGGCT	CHTF18_p.D679G
TTTGTGATCAGTATCTCATAGCG	CGCaCCTTTGCAAAGCTGC	TGGGCCGCACCTTTGCAAAGCTGCAGGGAG	CGNL1_p.T443A
TTTGTATCACATAGTCTATCGTC	GAAGCaCGCCCTGCTGGAG	CGCGAGAAGCACGCCCTGCTGGAGGGGCGG	LRPAP1_p.H324R
TTTGTACAGCATGTCAGTATCGA	GCACaCCCCACCTCTCCAC	TCACTGCACACCCCACCTCTCCACCGGCAC	PTK2B_p.T765A
TTTGATCATGTCACTATATCGTC	GTGaTGGCTGACCCACCCT	CAGTTGTGATGGCTGACCCACCCTGGGATA	METTL3_p.M393V
TTTGCATGTCATCATAGTATAGT	TCCTaTGCCATTAAGAAGA	CGAACTCCTATGCCATTAAGAAGAAGGACG	RPS5_p.Y188C
TTTGGTCAGTACAGCATCTCGTA	AGGaCTTTGACAGCGAGCG	GCCCAAGGACTTTGACAGCGAGCGGGGGTG	DDX54_p.D688G
TTTGATATCGTGTCATCTATAGC	CAAGTaTAATGCAGAAAGT	AATTCCAAGTATAATGCAGAAAGTAGGTAA	PSEN1_p.Y315C
TTTGGCGTGTAGCATCATCATCG	CTCaGTGGGTCGACGACGG	TATGTCTCAGTGGGTCGACGACGGTGGCTA	CUL9_p.Q2208R
TTTGATCACAGTACAGCATACGT	CAGCaGCGGCGAGCAGAGG	AGCGGCAGCAGCGGCGAGCAGAGGAGGCGC	KIAA1543_p.Q911R
TTTGGTATCAGCAGTGTATCAGA	CTCaTGCGGATTTGTGCGC	GAAGGCTCATGCGGATTTGTGCGCAGGCCC	C10ORF137_p.M876V
TTTGGTAGTATCGCACTATAGCA	CGGCGaCGGTGGCGGCCAA	AGAGTCGGCGACGGTGGCGGCCAAGGGGCA	NAA30_p.T63A
TTTGGAGTGTGTCATCTATCTAC	ATGCaGCTGAAGCAGATGA	AGAAGATGCAGCTGAAGCAGATGAAGGAGA	FAM179A_p.Q362R
TTTGATCAGTCACATAGCATCAC	GCTaGCAGTACTGGAAACT	GAACTGCTAGCAGTACTGGAAACTTGGTAG	CNTN4_p.S159G
TTTGGCAGTATCGTCAGTCAGTC	GCTaGCAGTACTGGAAACT	GAACTGCTAGCAGTACTGGAAACTTGGTAG	CNTN4_p.S159G
TTTGGTCACATATATCAGTCTAG	GCaCTGGCTCCCGGCGCTC	TGGCCGCACTGGCTCCCGGCGCTCCGGCTA	ATP8B2_p.T1155A
TTTGTAGTCAGAGCATCGTCATC	TGCGaCGCCAGCCAGGGCC	ACGTCTGCGACGCCAGCCAGGGCCTGGTCT	WISP2_p.D71G
TTTGTAGTCAGAGTCATCGCATC	GGCAaCCAGATCGGCGCCA	AGTGCGGCAACCAGATCGGCGCCAAGGTGG	TUBB2B_p.N14S
TTTGAGAGTCATCGTCATCTCAT	GTGCaCTGTGACTGCCTGG	AGGATGTGCACTGTGACTGCCTGGTGGCCT	C17ORF70_p.H157R
TTTGAGTATCAGTCACGAGTACA	GTGCaCTGTGACTGCCTGG	AGGATGTGCACTGTGACTGCCTGGTGGCCT	C17ORF70_p.H157R
TTTGTATCACAGCATATCATGTA	GAGTaCCCGACCCTCAAGG	TCCAGGAGTACCCGACCCTCAAGGTGGGCG	MAEA_p.Y19C
TTTGATCGTCATCATACTATATA	CACaTCGGGTGTGATGAGG	GGCTGCACATCGGGTGTGATGAGGTGGGTA	HEXDC_p.I145V
TTTGTAGTGTGTAGTCAGCATAT	AGCaTGGTTTGGTACAATC	AGATCAGCATGGTTTGGTACAATCTGGTGC	QRICH2_p.H542R
TTTGATACATCATCATACGACGC	CAGaCCCTGTGGTCCACGC	CCCTGCAGACCCTGTGGTCCACGCGGGAGC	EXD3_p.T31A
TTTGTGTGCAGTCTAGTATCATC	GTGaTGCGTGAATGGGCCA	TGCAGGTGATGCGTGAATGGGCCATGGCAG	APLP1_p.M329V
TTTGCACTGTATCGTCATCTACG	AGGGaAAGCAGCAAGCCCC	CCTCGAGGGAAAGCAGCAAGCCCCGGGCTG	PPP2R2C_p.E380G
TTTGCAGTGTATATCACATACGC	CCAaGGTGGGCCAGTGGGT	GACGCCCAAGGTGGGCCAGTGGGTGGGCAC	OSBPL5_p.K161R
TTTGGTCATCTCACTACGTATAT	GCCaGCTTGTGCAAGCTGG	CCCCAGCCAGCTTGTGCAAGCTGGAGGGTG	ZBTB47_p.S206G
TTTGTCAGATATCGTATCTATCA	GCTCaGAGGCCTCGGGAGG	TAGCTGCTCAGAGGCCTCGGGAGGAGGAAC	CD300A_p.Q282R
TTTGTCGTGTCATCGCTATATAT	GGGaATGATGAAAGGTGGT	GAAGTGGGAATGATGAAAGGTGGTAGGTAC	ESR1_p.G249G
TTTGGCATCATCACTAGCATCAG	GGGaATGATGAAAGGTGGT	GAAGTGGGAATGATGAAAGGTGGTAGGTAC	ESR1_p.G249G
TTTGCAGAGAGCATCGTCAGTCT	CCAaGTGGCCGCAGGCAGA	CAGCCCCAAGTGGCCGCAGGCAGATGGATA	GPR179_p.K213R
TTTGCACATCATCGTGTCTCGCA	CTCaTGACTTAGGAAAAGT	TCAGCCTCATGACTTAGGAAAAGTTGGAGA	HSPD1_p.H340R
TTTGCGTGTATCATCTCATGTGA	ATGGTaCCCCCTGTGAGGG	GATGGATGGTACCCCCTGTGAGGGCGGCCA	ADAM19_p.T505A
TTTGCGTAGCATCATATATATAT	TACaTCAACGGCCTGACGC	TCACCTACATCAACGGCCTGACGCTGGGCT	MPV17L2_p.I171V
TTTGTGCAGTATAGTATCATATA	TCGGGaCCAGCTGGCCAAG	ATGCTTCGGGACCAGCTGGCCAAGTGGCAG	SGSH_p.D466G
TTTGTCATATAGTATCGTCATAC	GGGCaCAGCACAGGACGGG	TGTCAGGGCACAGCACAGGACGGGGGGCCC	EPHA1_p.T376A
TTTGGTCAGCATGTGTATAGCTA	GCTGGaGGGGATGGTCAGG	TCAGGGCTGGAGGGGATGGTCAGGGGGAAG	FARP2_p.E1046G
TTTGTACACAGTATCTCTATCTC	CGGaGAAAAGCAGGTAGTC	GCTTCCGGAGAAAAGCAGGTAGTCCGGGAG	UNC5CL_p.R348G
TTTGGTCATGTGTACGTCATACA	GCCaCCACCACCACCACCG	CCATAGCCACCACCACCACCACCGGGGCTG	PBXIP1_p.H725R
TTTGATCTCGTCACTACGTATAT	TGGaCTTGCCAGCAGCCCC	GAGGCTGGACTTGCCAGCAGCCCCTGGGGC	PHRF1_p.D602G
TTTGCTCTATGCATCTAGTATCA	TCGGaTCAGTGGAGTTTGG	TGTCTTCGGATCAGTGGAGTTTGGAGGATA	NBEAL1_p.D1327G
TTTGTATCAGTATCGTGTCATAT	TCGGaTCAGTGGAGTTTGG	TGTCTTCGGATCAGTGGAGTTTGGAGGATA	NBEAL1_p.D1327G
TTTGATATGTCAGTATATAGCTA	TGAaCCACCGTGCCCAGCC	AGGTGTGAACCACCGTGCCCAGCCAGGCCT	ZNF195_p.N109S
TTTGGTCACATATCATCTACTAG	CTATGaCCTTGCGGAGATC	ACTGGCTATGACCTTGCGGAGATCCGGAGA	WDR54_p.D324G
TTTGCGTCGTCATCATCATACTC	ATaATGTATGGCTGCGACG	TCCAGATAATGTATGGCTGCGACGTGGGGT	HLA-A_p.I121M
TTTGGTACAGAGCATCTATCTAG	ATaATGTATGGCTGCGACG	TCCAGATAATGTATGGCTGCGACGTGGGGT	HLA-A_p.I121M
TTTGCGTCATCATCATAGCTATA	ATaATGTATGGCTGCGACG	TCCAGATAATGTATGGCTGCGACGTGGGGT	HLA-A_p.I121M
TTTGATGTCATCACTAGTACTAT	ATaATGTATGGCTGCGACG	TCCAGATAATGTATGGCTGCGACGTGGGGT	HLA-A_p.I121M
TTTGGCATATCATACTCATCGAG	TGTaCCCGTCCCTGGGGGC	AGAATTGTACCCGTCCCTGGGGGCCGGCTA	TBX6_p.Y8C
TTTGTAGTCATGTCATCGCAGTA	CCAaTTCAGCCTCCCGAGG	AGGCCCCAATTCAGCCTCCCGAGGAGGCGG	LRRC37B_p.I371V
TTTGTACTCATCGTCTATCACAC	AGCTGaCCACACTTCCGGA	GAACCAGCTGACCACACTTCCGGAGGGCAT	CPN2_p.T374A
TTTGTACATACGTCATCTACTAC	CTGATaCTGGTAAACTGAC	AGATCCTGATACTGGTAAACTGACTGGCGG	PHIP_p.T1030A
TTTGTCGTATCTCATAGTCTATC	GGACaAAGAAACTCTGGAA	TTTCAGGACAAAGAAACTCTGGAATGGTTC	CHL1_p.Q889R
TTTGATGTCAGACATCATATCTA	CGAGaGGAGCTCATCAAGA	AAGGCCGAGAGGAGCTCATCAAGAAGGGGC	PHACTR3_p.E106G
TTTGACACAGAGTGTATCTACAG	CGAGaGGAGCTCATCAAGA	AAGGCCGAGAGGAGCTCATCAAGAAGGGGC	PHACTR3_p.E106G
TTTGAGATAGTCATCATCGTCAT	CCGaGGACTGGGCTGGTGG	TTAACCCGAGGACTGGGCTGGTGGTGGCCC	TMEM215_p.R9G
TTTGACACAGTATCAGCATCTAC	TTTaCTGGTGGGGCTGAGA	TGCACTTTACTGGTGGGGCTGAGATGGTGC	OR4K14_p.T108A
TTTGATCACTATCATGTGTATAT	AAGaTTCAGAAACCCAAGG	CCAGTAAGATTCAGAAACCCAAGGTGGAAG	NEFM_p.I436V
TTTGGAGCATAGCATCTATCATA	CCATCaCCATCGAACTGTG	GCAGACCATCACCATCGAACTGTGGGGCTA	SUSD2_p.T193A
TTTGAGTCGTCATCATATCTACT	GCAGaTTTGAAGCAACTCA	AGAGAGCAGATTTGAAGCAACTCATGGTGA	MAP2K1_p.D351G
TTTGGCATAGCATCATGTCATAG	GAGaGTCTCCCGGAGTGGG	CAAGAGAGAGTCTCCCGGAGTGGGCGGGGG	ZBTB22_p.E591G
TTTGATGTCTACTATGTATCGCA	TTTTCaTGGTAGAGATGAG	GGTACTTTTCATGGTAGAGATGAGCGGAAT	C1ORF9_p.H399R
TTTGTGTGTCTATCATCTCATAG	CGaCGGTGCCACGGACCTG	TTCTCCGACGGTGCCACGGACCTGTGGCTG	XKR7_p.D70G
TTTGGTATCATCTCATGTCTACG	CCGCTaTGAGCGGGGTTCC	ACCTACCGCTATGAGCGGGGTTCCCGGGAC	INPPL1_p.Y663C
TTTGTACATCATGTCTCGTCACG	TACTaCCGCGAGAACAAGC	TCCCTTACTACCGCGAGAACAAGCAGGGCT	FOXG1_p.Y218C
TTTGTCATCTAGTCACTACGTGT	AGGaGTGAGTTGTCCACCC	TCCTGAGGAGTGAGTTGTCCACCCAGGGGA	CAMKK1_p.E375G
TTTGCTCATATATCAGAGTACGA	ATGCaAGCAACTGGGCTGT	GTGGTATGCAAGCAACTGGGCTGTGGGAAG	CD5L_p.K283E
TTTGATCTCATCGTCTATATAGC	TGGGCaAAGCAGAAGTGGA	GCTCTTGGGCAAAGCAGAAGTGGACGGAGC	POT1_p.K171E
TTTGATAGTCATGTCATCGTATC	GCCCCaGGTCAGACCCCTC	GATCAGCCCCAGGTCAGACCCCTCTGGAAG	TRIM46_p.R629G
TTTGACAGACATCTATCATCGCA	CGCaTCCTAGAGAGGATTG	TCGATCGCATCCTAGAGAGGATTGAGGACA	TCF25_p.I153V
TTTGAGTCTCTCATCTAGCATAG	CTACAaTTATCCCAGCTGG	CCAGACTACAATTATCCCAGCTGGTGGTGC	IMPAD1_p.I263V
TTTGGTGTATATCATCTACACTA	CTACAaTTATCCCAGCTGG	CCAGACTACAATTATCCCAGCTGGTGGTGC	IMPAD1_p.I263V
TTTGACATCACATATCATATCTC	GCAaCCGCCACGTGGTGCC	CACTGGCAACCGCCACGTGGTGCCTGGCGT	PRIC285_p.N298S
TTTGGCATCATCGCTCATAGCTA	AGGaTCTACTCCACCGCCA	TGAGCAGGATCTACTCCACCGCCAAGGTCT	ACE_p.I150V
TTTGCTGTATCGCACTAGTATAC	AACaGGCCCAGAGTGGCAC	AGCCCAACAGGCCCAGAGTGGCACTGGACA	NFYC_p.Q214R
TTTGACAGTATCATCTCGTCATC	GTGCaGGCAGTGAGCGCCC	CCCTGGTGCAGGCAGTGAGCGCCCTGGTAG	MESDC1_p.Q256R
TTTGAGTACAGCATCTCGTCATC	ACCaTTGATGGCCCCTCCA	CTGTCACCATTGATGGCCCCTCCAAGGTGC	FLNC_p.I2542V
TTTGGTGTGTATCGCAGTCAGTA	ACCaCCACCAACTTGTACC	TGCGGACCACCACCAACTTGTACCTGGGCA	MLNR_p.T72A
TTTGTCAGTGTATCAGAGTATCG	GTGGaCTGTGGGTATGTGC	GCTGGGTGGACTGTGGGTATGTGCTGGGGC	PDIA5_p.D84G
TTTGCGTATCTATCAGCATACGT	GCGaGAAACTCGCCAACTC	CAAGTGCGAGAAACTCGCCAACTCCGGCTT	MAFB_p.E299G
TTTGACATCACAGCATATAGTCA	TCTaTCCCGCTGGCCGCCC	GGGAGTCTATCCCGCTGGCCGCCCCGGTCC	C12ORF66_p.I5V
TTTGTAGTCATCTATAGCACTAC	ACTCCaGCACCCATGTCCT	CTGGCACTCCAGCACCCATGTCCTGGGGGC	TARS2_p.S135G
TTTGGAGTATCTATCAGCAGTCA	CTCAaGGCCAGCCAGGGCC	GTCACCTCAAGGCCAGCCAGGGCCCGGCCT	SPEG_p.R2790G
TTTGATCGTCTATCACATACGTC	ACATCaGCAAGGGTACGCT	GACCCACATCAGCAAGGGTACGCTGGGCAA	XRCC6_p.S569G
TTTGCACTATATCGCATCATCAT	ATCaCAGAGTGTGTCCTAC	TGGGAATCACAGAGTGTGTCCTACTGGTGG	OR2J2_p.T111A
TTTGCTCATCTCACTAGCGAGTA	CCAaGTCCCGCGGACGAGG	AGGAGCCAAGTCCCGCGGACGAGGTGGGGG	TTLL3_p.K287R
TTTGTACAGTATCATACTAGTAT	TGGACaGATGTGCTCTACT	AGGGCTGGACAGATGTGCTCTACTGGGTAA	CACNA1D_p.T367T
TTTGTCAGTAGTCGTCATCTCAT	TGGACaGATGTGCTCTACT	AGGGCTGGACAGATGTGCTCTACTGGGTAA	CACNA1D_p.T367T
TTTGGTAGTCAGTCAGCTAGTAG	TGGACaGATGTGCTCTACT	AGGGCTGGACAGATGTGCTCTACTGGGTAA	CACNA1D_p.T367T
TTTGCAGTCATCGTCAGCAGTCT	TGGACaGATGTGCTCTACT	AGGGCTGGACAGATGTGCTCTACTGGGTAA	CACNA1D_p.T367T
TTTGTCTCACAGTAGTCTATCGC	ATCaCCAAGGGCGTGGTCC	GCGCCATCACCAAGGGCGTGGTCCTGGACA	ABL1_p.T1028A
TTTGATCTATGCAGTATCATATA	ATCaCCAAGGGCGTGGTCC	GCGCCATCACCAAGGGCGTGGTCCTGGACA	ABL1_p.T1028A
TTTGTCTCTCATCGCATCTACTC	GATGaGCGGCCTGAGGCCG	ACGAGGATGAGCGGCCTGAGGCCGAGGACG	KIAA1279_p.E59G
TTTGTCTACAGTATCATACGTAT	CAGAaaGTGGTGGCTGGTG	CCTATCAGAAAGTGGTGGCTGGTGTGGCTA	HBB_p.K133K
TTTGTAGCATCGTCATCATATAC	CAaGTGAGTGCAGCCACCC	CAGGGCAAGTGAGTGCAGCCACCCTGGACA	CABIN1_p.K1637R
TTTGACAGTCAGTAGTAGTCACA	CATaTTTGCCGCAACACAG	GTGACCATATTTGCCGCAACACAGTGGGCA	SCUBE3_p.I291V
TTTGTATCATCGCGTAGCTATAT	TATaCCATGCCTCTTATAA	CAGCTTATACCATGCCTCTTATAAAGGCCA	TMC3_p.T479A
TTTGGCAGAGCAGTATCGTATAG	TTCaGGGACGACATGCCAC	TTGCCTTCAGGGACGACATGCCACTGGTGC	INPP5J_p.R368G
TTTGACTCTAGTATCAGCAGAGC	AGAaTGACCCAGGCAGAGG	GAGAAAGAATGACCCAGGCAGAGGAGGAAT	ELL2_p.M138V
TTTGTGATCAGCTATCATCTAGT	CACaGGCTGGAGCTGGCCA	GGCAGCACAGGCTGGAGCTGGCCATGGACT	FLJ23356_p.R178G
TTTGATGTGTGTATCTGTATATA	CTAaCCGGGCCTGTGACAC	ACTTACTAACCGGGCCTGTGACACTGGGCT	ASB3_p.N271S
TTTGGATCACTATATCTAGTACT	CTAaCCGGGCCTGTGACAC	ACTTACTAACCGGGCCTGTGACACTGGGCT	ASB3_p.N271S
TTTGTATATCATCGAGATCATCA	GTTCaGGAGGTGCTGCTGA	CCAGAGTTCAGGAGGTGCTGCTGAAGGCCG	HYOU1_p.Q306R
TTTGCTGTCTATCATCTACTCAG	GTTCaGGAGGTGCTGCTGA	CCAGAGTTCAGGAGGTGCTGCTGAAGGCCG	HYOU1_p.Q306R
TTTGATCACTGTATCGCTATATA	TAGCaGTGGCAGCAAAAAC	AGCAGTAGCAGTGGCAGCAAAAACCGGTCC	TMEM200C_p.S107G
TTTGCGTGTCATCATCTATAGTC	AGCCaAGTTCCCCATCAAA	GCTGGAGCCAAGTTCCCCATCAAATGGACT	ABL1_p.K400E
TTTGACGAGTATATCTATCTATA	TGCCaCAGGAGGAGGCAGC	CACAATGCCACAGGAGGAGGCAGCAGGTAA	CDK12_p.P1248P
TTTGATATGTATCACTCGTCTAT	AGGaGGCTGCTGCTGAGGT	TGGGAAGGAGGCTGCTGCTGAGGTCGGTGC	IL6R_p.R80G
TTTGATAGCATCACTAGTATCGC	AGTaCATGAGGACTGGGGA	GGACCAGTACATGAGGACTGGGGAGGGCTT	KRAS_p.Y71C
TTTGGTCACGTCATCAGCAGTAG	AGTaCATGAGGACTGGGGA	GGACCAGTACATGAGGACTGGGGAGGGCTT	KRAS_p.Y71C
TTTGGTATCTATCGCAGTCAGAT	TTATGaGCGATATATCCTT	ACCATTTATGAGCGATATATCCTTTGGACG	CRNKL1_p.E367G
TTTGCATCTCAGTACAGCATACT	CGTTaCTCTAAAGGAGGTG	GGAATCGTTACTCTAAAGGAGGTGAGGTGA	CLCN2_p.T831A
TTTGTGTCGTCTAGCATATATCT	CGTTaCTCTAAAGGAGGTG	GGAATCGTTACTCTAAAGGAGGTGAGGTGA	CLCN2_p.T831A
TTTGTACTATCATCGCACTAGCT	ACCAaCTGTGTGGAAGGTG	TTTCCACCAACTGTGTGGAAGGTGAGGCGG	ATP1A3_p.N238S
TTTGGCGTCTATCTACATCTCGC	ACCCCaGCGACGACACCAA	GGCGGACCCCAGCGACGACACCAAGGGCTT	PLEC_p.S3484G
TTTGTCGTCATACAGTATCGTCA	CCAGGaTCTGCCTGAAGAT	AGGCCCCAGGATCTGCCTGAAGATAGGTAT	C19ORF45_p.D242G
TTTGTGTCTACTACAGTATCATC	CCATCaTGTCCCTGACCAC	CACCACCATCATGTCCCTGACCACAGGCAC	HRC_p.H339R
TTTGAGTCAGATCAGCATATAGT	GGGaTGGACAACCATTTGG	GGGCAGGGATGGACAACCATTTGGAGGAGC	DBNDD2_p.M192V
TTTGATGAGTCTATCTAGTATAC	GCCaGTCTGGAGCAGCCCC	CACCTGCCAGTCTGGAGCAGCCCCCGGAGC	OBSL1_p.Q1246R
TTTGAGATCGTCATCTCATCACA	ATCAaCCAGGAGGGAAACA	TTGTGATCAACCAGGAGGGAAACATGGTTA	MOSC1_p.N98S
TTTGCGTGTATCTACATACGTAT	ATCAaCCAGGAGGGAAACA	TTGTGATCAACCAGGAGGGAAACATGGTTA	MOSC1_p.N98S
TTTGTCTAGTACATCATCGTATA	GAGAaGCCCCTGGCCTGGA	GTCCCGAGAAGCCCCTGGCCTGGAAGGGCA	KIAA0556_p.K780R
TTTGATATCATCATCATCACAGT	CTGTaTGGAGAGTGCCAGG	ATGTGCTGTATGGAGAGTGCCAGGAGGTCT	TMEM42_p.Y121C
TTTGAGTGTATCATCTATCACGT	CGTaTGTATGTAAGCTCCC	GAAGCCGTATGTATGTAAGCTCCCTGGCTG	GLI1_p.Y362C
TTTGCAGTCAGTATCGTGTCATA	TGGaGGCACTGAAGGCTGC	GGGCATGGAGGCACTGAAGGCTGCAGGCCC	ZNF512B_p.E400G
TTTGAGCATCATCATCGTCAGCT	CAGGaCGCCAGGCGGCGGC	GGCTGCAGGACGCCAGGCGGCGGCAGGAGC	PLEC_p.D1203G
TTTGTGTCATCAGCATCGACATC	AGGaGCCGTCGGGGGGCGG	CCTTAAGGAGCCGTCGGGGGGCGGCGGCAC	ZFP36L2_p.E103G
TTTGTACAGTCAGTCTACGTATC	AACaGGAGGTGTGTAGAAG	TTCTCAACAGGAGGTGTGTAGAAGCGGCGG	PET112_p.R113G
TTTGCTCATCATACTCATCGACT	AACaGGAGGTGTGTAGAAG	TTCTCAACAGGAGGTGTGTAGAAGCGGCGG	PET112_p.R113G
TTTGACATCGAGTCATATATATA	GGGGGaTGGTCTATGCCAG	GAGAAGGGGGATGGTCTATGCCAGAGGCTG	BLK_p.D210G
TTTGAGTCATCATGTCGCATAGC	GGGGGaTGGTCTATGCCAG	GAGAAGGGGGATGGTCTATGCCAGAGGCTG	BLK_p.D210G
TTTGACATCATCAGCAGAGAGTA	ACGaCCAGAAGGTGCAAGG	CACCTACGACCAGAAGGTGCAAGGGGGCAA	TPPP_p.D212G
TTTGTAGTCACTATCTATCATCG	ACAAGaACAAGCTACTGGT	TGTTTACAAGAACAAGCTACTGGTAGGTGG	KALRN_p.N1524D
TTTGACAGTATAGTATCGCATCG	ACAAGaACAAGCTACTGGT	TGTTTACAAGAACAAGCTACTGGTAGGTGG	KALRN_p.N1524D
TTTGGTGATCAGTATCATCTACT	GTCTTaCAGCTCTAAAGGG	CTGAAGTCTTACAGCTCTAAAGGGCGGCAC	OR4C6_p.Y226C
TTTGTACATCTACAGTAGCATCT	TCaCGCCCAGGAGGAAGAC	GGGCCTCACGCCCAGGAGGAAGACAGGTGA	TMEM51_p.H109R
TTTGGATCATCTAGTATCTATCT	TCaCGCCCAGGAGGAAGAC	GGGCCTCACGCCCAGGAGGAAGACAGGTGA	TMEM51_p.H109R
TTTGTGTGTCAGATCATATCGAT	TATGGaCAAGGACAGCCGT	CACACTATGGACAAGGACAGCCGTGGGGCG	WNK1_p.D62G
TTTGATAGTCACTAGTATCAGCA	GCTCTaTGAAGACGTTCTG	TATTTGCTCTATGAAGACGTTCTGAGGATG	ASB3_p.Y500C
TTTGGCATCGTCTATCATACGCT	TGGaTGGTTCGGGGAGCAT	AATTGTGGATGGTTCGGGGAGCATTGGAGC	SLC37A3_p.D431G
TTTGACAGTATCGTCAGCATCTC	TCCCGaATTTGATGGGAAG	GCCCTTCCCGAATTTGATGGGAAGAGGTTC	HSP90B1_p.E582G
TTTGGAGTCATCTACAGTATAGT	GCAaCGGCAGCGGCGGCGG	CGCGAGCAACGGCAGCGGCGGCGGCGGCGG	DACH1_p.N115S
TTTGTAGCATCATCTAGTAGTCG	GCAaCGGCAGCGGCGGCGG	CGCGAGCAACGGCAGCGGCGGCGGCGGCGG	DACH1_p.N115S
TTTGAGCTCATCTAGCATCGTCT	CGGCCaAGGTGACCGAGAG	GGTGACGGCCAAGGTGACCGAGAGCGGCGG	PPIC_p.K39E
TTTGGTATCAGATCAGAGTCTCT	GAGCAaGAGGTGGCTCAAC	TGTTTGAGCAAGAGGTGGCTCAACGGGAGG	SETD2_p.Q1624Q
TTTGGTATCAGTCACTCAGAGTC	GAGCAaGAGGTGGCTCAAC	TGTTTGAGCAAGAGGTGGCTCAACGGGAGG	SETD2_p.Q1624Q
TTTGTGTGTCATCATGTCTAGTA	GAGCAaGAGGTGGCTCAAC	TGTTTGAGCAAGAGGTGGCTCAACGGGAGG	SETD2_p.Q1624Q
TTTGTGTCAGCATGTATCGTAGC	GAGCAaGAGGTGGCTCAAC	TGTTTGAGCAAGAGGTGGCTCAACGGGAGG	SETD2_p.Q1624Q
TTTGATGTCATCATAGTATATAC	CGTGGaGGCGGTAAGGCCG	CACGCCGTGGAGGCGGTAAGGCCGCGGGCT	FAM160B1_p.E14G
TTTGTATCAGTATCTACATCTCT	ATGaCAGTGACTCAAGTTC	TTACAATGACAGTGACTCAAGTTCTGGACC	KCNH7_p.D594G
TTTGTATGTATCGCATATCATCT	ATGaCAGTGACTCAAGTTC	TTACAATGACAGTGACTCAAGTTCTGGACC	KCNH7_p.D594G
TTTGATCTGTATCATCGTCATAC	GGGGCaCCAGCCCTCCCAA	CCCCGGGGGCACCAGCCCTCCCAACGGCGG	ATXN2L_p.T31A
TTTGTCTCTATCATCTACTCTAC	GGGGCaCCAGCCCTCCCAA	CCCCGGGGGCACCAGCCCTCCCAACGGCGG	ATXN2L_p.T31A
TTTGTCACAGCATATATCGTCAG	GGAGGaGTTTGAGAGCTGC	AGCGCGGAGGAGTTTGAGAGCTGCGGGACT	WSCD2_p.E308G
TTTGGTGTCATCTAGAGCATCAG	GCAGTaCACCCCCTTATGA	TGACTGCAGTACACCCCCTTATGAGGGCCC	NEUROD4_p.T246A
TTTGGTGTATCAGCACTACATCG	TCaTCTACATCGGGCCCAA	CACCGTCATCTACATCGGGCCCAACGGCAC	KIF26B_p.I866V
TTTGACAGCATCTATCTCTACAG	GAGAaCCCGGACTGGTGAG	CGGCGGAGAACCCGGACTGGTGAGTGGGGG	FAM20C_p.N199S
TTTGACTATCATACAGTCAGTAG	GAGAaCCCGGACTGGTGAG	CGGCGGAGAACCCGGACTGGTGAGTGGGGG	FAM20C_p.N199S
TTTGCAGATCATCACAGCATGTG	TGATCaGATAAAACAGGTA	GAATCTGATCAGATAAAACAGGTAAGGTAT	TIMM9_p.Q10R
TTTGTGCTATCATATATCATCTA	AGGGTaAGGCTGAGGATCG	GAGGGAGGGTAAGGCTGAGGATCGAGGACA	ITGB7_p.K421E
TTTGGCTCATAGCATCTATCTAC	CCAaGGGTGGCTGTGGTTC	GGGATCCAAGGGTGGCTGTGGTTCCGGCTG	KRTAP5-1_p.K116R
TTTGCTCATCTCATAGTATCAGC	GTGaTCGGGGGTGTCCTCG	GAGCTGTGATCGGGGGTGTCCTCGGGGTGG	MPZ_p.I162V
TTTGGATCTATCGTCTGTATCTA	TTCaTGCTGCAGCAGATCG	CCTGCTTCATGCTGCAGCAGATCGAGGAGC	DGKZ_p.M189V
TTTGCATCATCGTCAGTATCAGT	AGAaCCGGAGCGTGCTTCA	CCAGGAGAACCGGAGCGTGCTTCAGGGTGC	PRODH2_p.N505S
TTTGAGTATCACAGAGCAGTATA	GGCaTGACTCACATCGTGC	AGGCTGGCATGACTCACATCGTGCGGGAAG	RPL3_p.M53V
TTTGCGTCATACAGTATCGTATA	CACTaTAAGATCCGCTGCC	TCAAGCACTATAAGATCCGCTGCCTGGATG	BLK_p.Y177C
TTTGGTCTAGTATATCAGTCAGT	CACTaTAAGATCCGCTGCC	TCAAGCACTATAAGATCCGCTGCCTGGATG	BLK_p.Y177C
TTTGCTGTCTAGCATATATATCA	CTGGTaGTGGTGGGGGCGG	ATGCGCTGGTAGTGGTGGGGGCGGGGGAGG	VIL1_p.001
TTTGATGTCATCTGTATCAGCTC	GGCGCaGAGGGCCGGGCAG	GCCAAGGCGCAGAGGGCCGGGCAGCGGCGC	TONSL_p.Q18R
TTTGTCTATCATCGTCTATAGTC	GAaGTGCGTGCGTTCCTTC	CCGGGGAAGTGCGTGCGTTCCTTCAGGAGA	APOBEC3B_p.E292E
TTTGCACATATATCTCACTAGCG	TGCGaCGTCCACAGAGTCC	TCACTTGCGACGTCCACAGAGTCCTGGAGC	SPEN_p.R732R
TTTGCGAGCATCATCATCTAGTA	CTATCaGTGCACTGAATGT	AAGCCCTATCAGTGCACTGAATGTGGGAAA	ZNF594_p.Q489R
TTTGATACATCTACAGTATCGCT	GGTCaGTTAAAAGTCCAAC	ACAGAGGTCAGTTAAAAGTCCAACTGGCTT	ST8SIA3_p.Q270R
TTTGTCGTCAGCAGTATCTATAC	CCCaAGGCAGGAAGATGGG	GGTGTCCCAAGGCAGGAAGATGGGTGGCAC	CYP2A7_p.001
TTTGGTCGTCATCTCGTATCGCT	CCCaAGGCAGGAAGATGGG	GGTGTCCCAAGGCAGGAAGATGGGTGGCAC	CYP2A7_p.001
TTTGTATGTCTATCAGCATCGTC	CCaCCACCACCACTGACCT	CCTGGCCACCACCACCACTGACCTAGGTGT	RIN3_p.T722A
TTTGCATGTCTATCACTATATAC	GAGAaGGCGGTGCCTGGGG	AGCACGAGAAGGCGGTGCCTGGGGAGGTCG	ALPK3_p.K406R
TTTGTACATCATCATCACTAGTC	ATATGaGGATTCATAAGAG	TAAACATATGAGGATTCATAAGAGAGGCAA	ZFP90_p.R414G
TTTGATCATCGTGTCTAGCTATC	ATATGaGGATTCATAAGAG	TAAACATATGAGGATTCATAAGAGAGGCAA	ZFP90_p.R414G
TTTGCATACATGTCATATATCAT	ATGGTaGAGTTTGCAGGAT	TTAGGATGGTAGAGTTTGCAGGATTGGTTT	UBR5_p.R66G
TTTGGTCTGTATCATCACATACT	CAAGaCACCCTCTTCCTGA	ATGGTCAAGACACCCTCTTCCTGAGGGCCA	SNTA1_p.D245G
TTTGCTCATCATCGCGTATCTAT	CATGaGGAGTAGCAGCAGA	CTGACCATGAGGAGTAGCAGCAGAAGGTGC	SLC18A1_p.E524G
TTTGATAGTATCATCTCACGACG	GTCaGAGACAGTGGACACT	CTGCAGTCAGAGACAGTGGACACTGGGGGT	FLG_p.R1059G
TTTGATCGTATCAGCAGTCAGAT	CAGaGTAGGCCTTTGGCTT	GTCCTCAGAGTAGGCCTTTGGCTTCGGATT	CCDC110_p.S812G
TTTGCATACATCATCTAGCTATC	GAGCTaCAAGGTGGTGTCA	ATGGAGAGCTACAAGGTGGTGTCAGGGTGG	PAX7_p.Y495C
TTTGGTGATCATCTATCGCGTAG	GAGCTaCAAGGTGGTGTCA	ATGGAGAGCTACAAGGTGGTGTCAGGGTGG	PAX7_p.Y495C
TTTGACACAGTATCGTATCTATA	GGTGCaGGCGGGTTGTCCA	CAAGGGGTGCAGGCGGGTTGTCCAGGGGGC	IGFBP6_p.Q37R
TTTGTGATCATCGCATCTAGCGC	GAGTTaCTGCCTTTTCGGG	GGGACGAGTTACTGCCTTTTCGGGAGGCTG	SLC4A1AP_p.Y188C
TTTGTGTCATCTCACGTATCAGT	CTGCTaCAGGTGCTTGGGG	CTAGTCTGCTACAGGTGCTTGGGGAGGGAG	SHKBP1_p.Y217C
TTTGCATATATCATCTAGTCAGA	ACaTCATCCAGAATGACAC	CCAGAACATCATCCAGAATGACACAGGATT	CEACAM5_p.I112V
TTTGTCTATCAGTCTATCTCTAG	CAACaTACAGTGGAGCCCC	AAAGCCAACATACAGTGGAGCCCCTGGGGA	CNST_p.H328R
TTTGAGTGTGTCTATATCAGTAG	TGGCCaTGACAGGACATGC	GTCACTGGCCATGACAGGACATGCTGGCAG	PRICKLE2_p.M457V
TTTGTCACTCATCACTACGTGTC	CCTCaCCTTCATCTAGGCC	ACCTGCCTCACCTTCATCTAGGCCTGGCCG	MOGAT3_p.H271R
TTTGTACAGCAGTATCAGCATAT	TAATaAAGCTGATTGACTT	TGGAATAATAAAGCTGATTGACTTTGGCTG	YSK4_p.I1200M
TTTGTAGTCTAGTATCATATCTC	TAATaAAGCTGATTGACTT	TGGAATAATAAAGCTGATTGACTTTGGCTG	YSK4_p.I1200M
TTTGCATCACTATCTAGTACAGC	CTCTaCAAGTCTGAGATGG	CTGACCTCTACAAGTCTGAGATGGAGGTCC	PA2G4_p.Y343C
TTTGCTCATCTCAGTATCGATCG	GGACaCGGTGGGCGTGGTA	GCAGGGGACACGGTGGGCGTGGTACGGCGG	NEURL4_p.T637A
TTTGTATCAGAGAGTCTAGTATA	GCCCaTGAATGCCATGCAG	GAGGTGCCCATGAATGCCATGCAGAGGCCC	BCL9L_p.M626V
TTTGTAGTGTGTCATCACTATCT	GATGaTGTTGACAACCCCT	ATGCTGATGATGTTGACAACCCCTTGGGAG	C7ORF72_p.D336G
TTTGACATCTCAGTATCGCATAG	GACTaTGCCTGGACGCCCA	TGCAGGACTATGCCTGGACGCCCAAGGAGG	ABCC6_p.Y1239C
TTTGCTCACAGATCAGAGAGTAT	CAGGGaAGGAGCTGGTAAC	GTCAGCAGGGAAGGAGCTGGTAACTGGCCA	DCDC2B_p.K189E
TTTGGTCAGAGTCTATCGCAGTA	GAAaGGGACGGGCGGTGCC	TGGAAGAAAGGGACGGGCGGTGCCCGGTTG	FUT4_p.K43R
TTTGCATCTATGTATCATATATA	GAAaGGGACGGGCGGTGCC	TGGAAGAAAGGGACGGGCGGTGCCCGGTTG	FUT4_p.K43R
TTTGATCATCTCGTCATCTCATC	TCCTaTTTGGAGATCTACC	GGGCCTCCTATTTGGAGATCTACCAGGAAG	KIF3C_p.Y145C
TTTGCGTCAGTATCTACATCTCA	AGGaAGAAAAGAAAACATG	CATGGAGGAAGAAAAGAAAACATGGGGCAC	PAH_p.E182G
TTTGCTACTAGTATCATCATCTG	AGCaTCTTATCCGAGTGGA	TCCTCAGCATCTTATCCGAGTGGAAGGAAA	TP53_p.H100R
TTTGTGTATCTACATCACTAGCT	TGTaTGAGCACGAGCGGGA	GTACGTGTATGAGCACGAGCGGGAAGGGAA	GRM1_p.Y1111C
TTTGAGCATATCATCATCATACA	AAAaGCACCCTGGTTCCCT	TAGGAAAAAGCACCCTGGTTCCCTTGGACA	MUC16_p.S1215G
TTTGCTATATCAGTCTATCTACA	GGaGCTAACGGTGGCTGTG	CGGAAGGAGCTAACGGTGGCTGTGAGGGAC	RUNDC1_p.E429G
TTTGTACAGAGTGTATCTATCAC	CGTaTGAATGTAAACAATG	GAAACCGTATGAATGTAAACAATGTGGTAA	ZNF439_p.Y242C
TTTGTATGCATCATCACATATAT	GAGGaTGTGGCCATGCAGG	CAGCGGAGGATGTGGCCATGCAGGTGGAGG	TGM1_p.D578G
TTTGCATATATGTATCATCGTAT	CTGaCTGGAGGAGGTGCCC	TTCTCCTGACTGGAGGAGGTGCCCTGGCCG	MBOAT4_p.T46A
TTTGCTCACATCATACTCTAGTC	GTCAaTGCCCGAGGACTCT	TTAGTGTCAATGCCCGAGGACTCTTGGAGT	GANAB_p.N171S
TTTGTGTGTATCATCATCAGCGT	GGaGGGCTTCGGCTCGCTG	GTGCAGGAGGGCTTCGGCTCGCTGCGGCGC	SAC3D1_p.E160G
TTTGATAGTCATCATCACTATGA	CGCCaTTGCTGTGGTTGCT	CTGATCGCCATTGCTGTGGTTGCTGGGCTC	SYT2_p.I68V
TTTGATCATCTCAGAGAGCATAT	CTGTCaGACCACCTGTTGC	AGCTGCTGTCAGACCACCTGTTGCAGGACC	KRTAP4-9_p.Q71R
TTTGCATCTATCATCTATCTCTA	ACGCaGGGTGAGCGAGCCC	AGACTACGCAGGGTGAGCGAGCCCGGGAGC	MSI1_p.Q33R
TTTGCTAGTATCACTATCATATG	GGaGGCCGAGGGTGTGCTC	GCAGAGGAGGCCGAGGGTGTGCTCTGGTGA	PCDHA4_p.R755G
TTTGTAGCATCTCTACGAGTATC	GCAGaCCCTGAAAAAGGCA	GATGAGCAGACCCTGAAAAAGGCAAGGAGA	BMP3_p.T355A
TTTGACAGTATCATATACGTCTA	CTACaGAGAGGGTCCTTCA	CAACACTACAGAGAGGGTCCTTCAGGGCCT	MUC16_p.T13818T
TTTGTGTCATGTGTCTATATCGA	TCAATaCTTATAGAGGCTT	GGTTTTCAATACTTATAGAGGCTTGGGAAC	NAALADL2_p.I745M
TTTGTCGTCATAGTCAGTATCGA	TCTaATCTTTCACAGACAC	GAAATTCTAATCTTTCACAGACACAGGTAG	TCFL5_p.N224D
TTTGATCTCTAGTCATCATCTAG	CTGaCTGTGGCAAGACCTT	TTGTCCTGACTGTGGCAAGACCTTTGGGCA	ZNF576_p.D116G
TTTGCTATCGAGAGCATCATCTC	AGGaGCTCCCCTGGAAGAG	AGAAAAGGAGCTCCCCTGGAAGAGTGGGCA	SLC9A5_p.E761G
TTTGCTATGTCACTATCATCATC	GAGaACTTGGCCTTAGTCC	AATGCGAGAACTTGGCCTTAGTCCTGGTAA	FBXO8_p.E252G
TTTGTGTGTATCGTCTAGCTATA	GAGaACTTGGCCTTAGTCC	AATGCGAGAACTTGGCCTTAGTCCTGGTAA	FBXO8_p.E252G
TTTGGATATCAGTCTATCGACAT	AGCCaTCGGCATCATGAGA	GCCGAAGCCATCGGCATCATGAGAAGGGTG	PKN1_p.I843V
TTTGTCATCACTCATCTATCTCT	ACGCaGCTCATCTCCAACA	TCGCCACGCAGCTCATCTCCAACATGGACA	ALPPL2_p.Q208R
TTTGTCTATGCAGTATCTATAGC	GAAGaGGAGTTGTCTGAGG	CACCGGAAGAGGAGTTGTCTGAGGAGGAGG	SALL2_p.E760G
TTTGCTAGTCAGCATGTATCGCG	AGGCaCTCCACCCTGGGCA	TGCAGAGGCACTCCACCCTGGGCATGGAGA	KIF16B_p.H1022R
TTTGCATCATGTCTCGTCACTCG	TTCCaTTAAAGTGGACACG	CTGTCTTCCATTAAAGTGGACACGCGGTAC	UBR4_p.I3550V
TTTGGTAGTCATCTAGCAGTCAC	TGGTaGACGACCTGTCCTC	CCCGGTGGTAGACGACCTGTCCTCGGGCGA	KIAA1549_p.V1500V
TTTGCTCATCATCATACTCAGCA	TGCaCTGGGTTCGGCATCC	CCAGGTGCACTGGGTTCGGCATCCAGGAGA	VSX2_p.T30A
TTTGGATCAGCATCACGTCTACT	TCTGGaGCAAAGGGAGATC	CTGCTTCTGGAGCAAAGGGAGATCTGGCTG	KIAA0146_p.E667G
TTTGTGCATACTCATCGTCTAGC	AAAaTAATGAACCTCTTCG	TGGGAAAAATAATGAACCTCTTCGTGGCTA	SLC12A2_p.N648S
TTTGCAGTGTGTATCACTCGCGT	AAAaTAATGAACCTCTTCG	TGGGAAAAATAATGAACCTCTTCGTGGCTA	SLC12A2_p.N648S
TTTGCAGTCTCATCATCATCGAC	GAGCaGGTCCTGGTGGATG	CTGGGGAGCAGGTCCTGGTGGATGTGGAGA	MRPS25_p.Q85R
TTTGTACTATATCAGCATCATAC	CGGGaGCCTCTCAGCGTCC	GGCGGCGGGAGCCTCTCAGCGTCCCGGGCT	GIPC2_p.S31G
TTTGTATACGCATCATCACTATA	CAAaGCCTGCTGCATTCCT	GCTTCCAAAGCCTGCTGCATTCCTTGGCCC	C7ORF10_p.S378G
TTTGATGTATCACTATCTAGCGC	ATGTGaGCCGAGTACAGGT	GTTGAATGTGAGCCGAGTACAGGTAGGTCA	NRXN3_p.E356G
TTTGTACTGAGCATCTATCATCA	GTGGaCAATGCCATCCATG	AGCAGGTGGACAATGCCATCCATGAGGCCA	ERCC6_p.D114G
TTTGTCGTCATCATATATCATCA	GCTCaGCCAGGATTTGCTC	GAGCAGCTCAGCCAGGATTTGCTCAGGTAG	BTBD8_p.S45G
TTTGGTATATATCTACAGATCGC	TTCaGCGGCAGAATCAGCA	TGCTGTTCAGCGGCAGAATCAGCATGGCCA	ARHGAP32_p.S219G
TTTGACATATCATCAGCAGTATA	TGCAaGGCCTCTGAGGTAC	CTGACTGCAAGGCCTCTGAGGTACAGGAAT	SHCBP1_p.K94R
TTTGATATAGTCATCATCTACAT	GGGGaGGAGCCAGTGCGCA	ACGGCGGGGAGGAGCCAGTGCGCAAGGAGA	DOCK4_p.E1849G
TTTGTAGATCATCTAGTCAGCTA	TACGaCGGAGAGGGGAATG	ACGAGTACGACGGAGAGGGGAATGAGGAGC	ABR_p.D30G
TTTGTGTCGCATGTCATCATACG	ATCaGTGGTGACGATGATC	ATCTGATCAGTGGTGACGATGATCTGGAGG	EXOC7_p.S175G
TTTGTCAGTGTGTATCTAGTATC	GCaCTTTCAACTTCCTTCA	AGCCTGCACTTTCAACTTCCTTCAAGGCAG	DISC1_p.H391R
TTTGAGCATCTCATCGTCTATAC	AACaTGGAGGCTGGCTCAG	TATAAAACATGGAGGCTGGCTCAGTGGTTC	DNMBP_p.M1V
TTTGAGAGAGCATCACTATCGCA	TTCAaTGGGGAAATGGAGC	ATGACTTCAATGGGGAAATGGAGCAGGAAG	ADD2_p.N262S
TTTGGTGTCTCTATCGACATCTA	TCAGCaTGCAAGGTGGGCG	AGACCTCAGCATGCAAGGTGGGCGGGGCGG	MSLN_p.M601V
TTTGTATAGTCAGTGTATATCTC	CTTCaGGGTCTGCACATCG	CCGCGCTTCAGGGTCTGCACATCGCGGTCC	WNT10B_p.Q74R
TTTGGCATCTATGTATCGTCTAC	GTTTGaTGGCTGATCTTGA	TCCAAGTTTGATGGCTGATCTTGAAGGTTT	AP3B1_p.M843V
TTTGTCACATCTCATCACAGCTC	CCTCaCCGACCTGCGCATG	TTCACCCTCACCGACCTGCGCATGCGGCTG	NTNG2_p.T250A
TTTGTGTGTGTATCAGCGTATCA	GCAGaCGAGCTGCGGAGAG	CATCTGCAGACGAGCTGCGGAGAGTGGTAC	SUSD5_p.D72G
TTTGAGAGTACAGCATATCATAC	ACTCaGTTGGCAAATGACC	AGGTGACTCAGTTGGCAAATGACCTGGCAG	MYH15_p.Q1280R
TTTGCTATCTGTATCGCATCATA	CCaGCCTGTGCTGCGGGCA	GTGCGCCAGCCTGTGCTGCGGGCACGGCAC	PROC_p.S103G
TTTGGTATCGCATCACTATAGCA	AGAaCTGCGGTGTTCCCGA	ACTACAGAACTGCGGTGTTCCCGAAGGCCA	MYPN_p.N1180S
TTTGGTGTGCAGTATCATCTAGC	TCGACaGCTACAACAGCCG	GTACATCGACAGCTACAACAGCCGCGGCTT	NDUFAF3_p.S62G
TTTGTATATATCGCAGTCAGTCT	ACCaTCTTGAGAGGAACAG	CCAAGACCATCTTGAGAGGAACAGAGGAAA	EEF2K_p.I349V
TTTGCATCTATCACAGTAGCATA	GAGATaCCAGGCCCAGACC	ACTGTGAGATACCAGGCCCAGACCTGGAGG	TRIM10_p.I46M
TTTGAGTCATCTGTGTATAGCAG	GAGATaCCAGGCCCAGACC	ACTGTGAGATACCAGGCCCAGACCTGGAGG	TRIM10_p.I46M
TTTGGTCAGTATAGTACATGTCT	GAAAaTTCTTGGGATACTG	ATGAAGAAAATTCTTGGGATACTGAGGTAC	ANKRD30A_p.N627S
TTTGGTCATCATCTATAGCATCT	GGAGGaTGGCTGGACCAAG	GCCCAGGAGGATGGCTGGACCAAGGGGCAG	RAPGEF3_p.D551G
TTTGTGACATCTATCAGTCAGCT	ACGATaTTGTAAACAGAGG	TGTCCACGATATTGTAAACAGAGGAGGCAG	CPSF3_p.I229V
TTTGCTCATCTACAGAGTATCGA	ACGATaTTGTAAACAGAGG	TGTCCACGATATTGTAAACAGAGGAGGCAG	CPSF3_p.I229V
TTTGTCATCGTGTCTAGCATCGC	ACAaTCTTCAGATTCAATG	ATAGAACAATCTTCAGATTCAATGCGGCTT	SCN7A_p.I89V
TTTGTACATCTGAGCATCTATAG	GCGaTGCTCGGGTTCCCCC	GGATAGCGATGCTCGGGTTCCCCCCGGGTC	ZNF211_p.M1V
TTTGTGTCATATATCATGTCTAC	CCaCCCCCTCCTCCAGCCC	CACAGCCACCCCCTCCTCCAGCCCAGGGAC	MUC5B_p.T2598A
TTTGATCTATCATCGTATCAGCT	GGGGaGTGCAGGCAATCCG	ACGGCGGGGAGTGCAGGCAATCCGAGGACT	NOTCH1_p.E843G
TTTGCATCATCACTATCACGAGT	GGGGaGTGCAGGCAATCCG	ACGGCGGGGAGTGCAGGCAATCCGAGGACT	NOTCH1_p.E843G
TTTGTATATCGCATCACGTATCT	GGGGaGTGCAGGCAATCCG	ACGGCGGGGAGTGCAGGCAATCCGAGGACT	NOTCH1_p.E843G
TTTGCACAGTAGTCTATCAGCAC	GGGGaGTGCAGGCAATCCG	ACGGCGGGGAGTGCAGGCAATCCGAGGACT	NOTCH1_p.E843G
TTTGATATCAGCATAGTATCGAC	ACCGaGGGCTGGGAGGAGG	AGGAGACCGAGGGCTGGGAGGAGGTGGAAC	HAP1_p.E538G
TTTGGTATCAGATCGCATATAGT	CCGCCaTCCAGGCCATGAA	GCAGACCGCCATCCAGGCCATGAACGGCTT	CELF4_p.I459V
TTTGAGACAGTGTATCGTAGCTA	GGGaGAGCAGAGGGTGCTC	GCTTCGGGAGAGCAGAGGGTGCTCAGGAGG	STRADA_p.E341G
TTTGAGTCTATATCATCGTCTAC	GGGaGAGCAGAGGGTGCTC	GCTTCGGGAGAGCAGAGGGTGCTCAGGAGG	STRADA_p.E341G
TTTGGATCTATCGTCATCTATAC	CAGGaGGCCAAGGAGCTGA	AGGTCCAGGAGGCCAAGGAGCTGAGGGAGC	MYOM3_p.E141G
TTTGACATCTCATCACAGCAGTC	ACAGTaGCTATGGAGCTTG	ACCTGACAGTAGCTATGGAGCTTGTGGTGG	SETD2_p.S1277G
TTTGGTCTCGTCATACGCATCGC	CACCCaAGAAGGAGAAAGG	CATGGCACCCAAGAAGGAGAAAGGAGGAAC	SPAG17_p.K4E
TTTGGAGTGTATATCTATCAGCA	GTGaCGACCCCCTGGCCGG	GAGCGGTGACGACCCCCTGGCCGGGGGCTT	ADCY5_p.D86G
TTTGTAGTCTGTATCGTCACTAG	CCaTTTCACCACCATTGCC	TGCTCCCATTTCACCACCATTGCCAGGCCA	SKP2_p.H392R
TTTGTGTAGCATATATCATCATC	TAGAAaCTGGAAAGTGAAG	GCCAATAGAAACTGGAAAGTGAAGTGGTGT	CPA6_p.N273S
TTTGATCGCTATCAGCATATATA	TAGAAaCTGGAAAGTGAAG	GCCAATAGAAACTGGAAAGTGAAGTGGTGT	CPA6_p.N273S
TTTGAGTACAGTATCTCTACAGT	GCACaGGTAGGGAACCTGA	CCTGGGCACAGGTAGGGAACCTGAAGGCCC	ZBTB17_p.001
TTTGGTCTCATCATAGCACTAGC	TGGCCaTAGGTGTTGGGGA	CTCTTTGGCCATAGGTGTTGGGGATGGCAT	GEMIN5_p.I397V
TTTGTATGTAGTCAGTGTATCTC	GATGaCTGGGGGACCCTGG	GTGGGGATGACTGGGGGACCCTGGAGGCCA	LOXL3_p.D449G
TTTGTATCAGAGCATCATATCAG	CCACaGGTAAGCCTCATCA	AGGTGCCACAGGTAAGCCTCATCAGGGTGA	GRB2_p.Q156R
TTTGTGCATCATCTATGTACGCT	TGaGCGCTGGCGCGACGGC	GTGGATGAGCGCTGGCGCGACGGCTGGAAG	GFER_p.E193G
TTTGCAGACAGTCAGTATCACTA	AGAGaGGCCCCAGGGAGGA	AAAGCAGAGAGGCCCCAGGGAGGAAGGCAC	LRRC66_p.R323G
TTTGCTGTCTCTAGTATCAGAGC	CTTTaTAAAACACAAGTTA	AGACCCTTTATAAAACACAAGTTAGGGAGC	ROCK2_p.Y876C
TTTGTAGAGTCGTCTATATCATC	CTTTaTAAAACACAAGTTA	AGACCCTTTATAAAACACAAGTTAGGGAGC	ROCK2_p.Y876C
TTTGCAGCATCGACATCATCTCT	AAGGaGATTAAGGATGGGA	TCACCAAGGAGATTAAGGATGGGAAGGTCA	KRT39_p.E467G
TTTGATCTACAGTCACGTATCTA	GCTGaGGGCCTGCTGCAGG	AGGCCGCTGAGGGCCTGCTGCAGGAGGCGC	COPE_p.E236G
TTTGCATAGTATCATCGTCACAT	GCTCaCCTGTGCAGTAGGT	GGCAAGCTCACCTGTGCAGTAGGTAGGCGA	ATP9A_p.T780A
TTTGAGTGTGTCTAGCATCGACA	AGAACaCCCCAATGATTGC	GACAGAGAACACCCCAATGATTGCTGGCCT	SCLY_p.T299A
TTTGTACATCTAGTATCGCTATC	CAGGaTGAAGCTGTATGGC	TGGCACAGGATGAAGCTGTATGGCTGGAGC	MPG_p.D239G
TTTGCATCAGTCTCATATACGTA	GAACaAAGTGATAATGAGC	TGCCTGAACAAAGTGATAATGAGCTGGAGC	ESCO1_p.Q287R
TTTGGATCAGCATATATCACTAC	CAGAaGGTCAGTCTGTGTG	TAGCCCAGAAGGTCAGTCTGTGTGTGGGAC	TMEM91_p.K120R
TTTGATGTGTATCATCTCATGAT	GTGCaTGGTGGACAACTCG	AACCCGTGCATGGTGGACAACTCGGGGAAG	CASKIN1_p.M143V
TTTGTCTACATAGCATCATATAT	TGATaCCGGCAGCCCAGCC	TGTGCTGATACCGGCAGCCCAGCCTGGGCA	LCN12_p.I96M
TTTGCTCTCATAGTATCAGCATC	ACGTCaTGCTGCTGCCTGT	CAAGAACGTCATGCTGCTGCCTGTGGGGTC	CNDP2_p.M433V
TTTGCACATAGTCTCATAGTATC	ACCaTGGCCGAGGCGCCTC	GGGTCACCATGGCCGAGGCGCCTCAGGTGG	FOXO1_p.M1V
TTTGCATGTATAGTATCATCACA	CTGCaGGGGTCCCCCTGAT	CAGGACTGCAGGGGTCCCCCTGATAGGCGT	WDR33_p.R997G
TTTGGTCAGTATAGAGTATATAT	GGaACGTGAGCGGTGGCAG	CAGAGGGAACGTGAGCGGTGGCAGCGGCAG	DAAM2_p.E1000G
TTTGGATATCGTCTATAGCATCA	GGaACGTGAGCGGTGGCAG	CAGAGGGAACGTGAGCGGTGGCAGCGGCAG	DAAM2_p.E1000G
TTTGATGTCACTCACTATCTATC	GGCTCaCTGCAGAACTGGT	GCCTGGGCTCACTGCAGAACTGGTGGGTAC	COL16A1_p.T938A
TTTGTCTAGCATCATCTCTATCG	CGGCTaCCATGCTGGAGAT	CCACACGGCTACCATGCTGGAGATAGGAAC	ANGPT1_p.T126A
TTTGACATGATCATATCATCGCG	CAATaaCGGTGAGTGGCGG	CGGCGCAATAACGGTGAGTGGCGGAGGGGA	ZEB1_p.N19D
TTTGATGTGTCATCAGCATACGC	TGTGaCTCTGATGAGGATG	CAGACTGTGACTCTGATGAGGATGAGGACT	SEPT4_p.D305G
TTTGTGTGTCATCATCACTATGT	GCTTaCAAAGCCAAAGGAG	AGATCGCTTACAAAGCCAAAGGAGAGGAAA	NEB_p.Y1017C
TTTGATATCTAGTACAGTAGTAC	GCTTaCAAAGCCAAAGGAG	AGATCGCTTACAAAGCCAAAGGAGAGGAAA	NEB_p.Y1017C
TTTGTACATCATGTCGCAGTATA	CGTGaGGGAGAATTGCCAC	TTCGCCGTGAGGGAGAATTGCCACTGGAAG	SRCAP_p.E327G
TTTGTATCTATATCAGCATCACG	CTTaCACTGCCGCGCCCGG	CGACCCTTACACTGCCGCGCCCGGCGGGGA	C1QL2_p.Y36C
TTTGACATCTCAGTACATCTCAT	GAGCaGATCTCAGGCACTG	GAGGGGAGCAGATCTCAGGCACTGTGGGCT	EGFL4_p.Q194R
TTTGATATCAGAGTATATAGTAT	TGGTCaTGGTGGAAGGCTT	GATGCTGGTCATGGTGGAAGGCTTTGGGGG	OSTALPHA_p.M134V
TTTGATGTGTCATCTATCACGTC	ACaTTTCACAGCTACAGAA	GCTTTACATTTCACAGCTACAGAAAGGAAA	BRMS1L_p.I310V
TTTGTCATCTCACATCATACGTG	TCCAGaGGCAGGTGGGTGC	GAACTTCCAGAGGCAGGTGGGTGCTGGCAT	SMARCA4_p.R414G
TTTGGATCATCATCACGAGAGCA	ATGCaGCAGCAGGCGGCCC	AGCTGATGCAGCAGCAGGCGGCCCTGGTAG	CELF3_p.Q213R
TTTGACATATCATCAGCATCTCA	GAGGaCGAGGACGAGGGAG	GCTCAGAGGACGAGGACGAGGGAGTGGAGC	HIF3A_p.D528G
TTTGAGATCAGCATACATCTCGC	AGCTaCGACATCAGTATTG	GACAGAGCTACGACATCAGTATTGTGGCCC	CARM1_p.Y448C
TTTGACTATATCATCTACATATA	AATaTGACCGTGCTGGTGT	ATCTCAATATGACCGTGCTGGTGTCGGACG	PCDHB8_p.M438V
TTTGTCGCATCATAGCTCTATAT	ATGGGaAAAAATAGAGGTA	GCCATATGGGAAAAAATAGAGGTAAGGTGG	AKAP6_p.E779G
TTTGGTCTCAGTATCTATATCGA	CTTaGATTTTAAGGCTAGG	CCCCACTTAGATTTTAAGGCTAGGTGGAAT	DHX36_p.001
TTTGTCATACATCATACTCACGT	CAAaTGAAATAAATGCCAC	GACTTCAAATGAAATAAATGCCACAGGCCA	CD109_p.N797S
TTTGAGTCTCAGTGTATCTAGCT	GCTaTCGAAAGGTGAGAAA	GAAAAGCTATCGAAAGGTGAGAAATGGCCA	ZKSCAN2_p.Y404C
TTTGGTATCAGCATCGACATCTA	ATGaCAACCTGTTCCACCG	TCAGTATGACAACCTGTTCCACCGTGGCCG	SLC10A6_p.T130A
TTTGTATGTATCGTCATCTGCAT	ATGATaCCAAAGATAATCT	TAGAAATGATACCAAAGATAATCTTGGTAA	CTAGE1_p.T635A
TTTGCATCGCATGTCATCATCTA	ATGATaCCAAAGATAATCT	TAGAAATGATACCAAAGATAATCTTGGTAA	CTAGE1_p.T635A
TTTGTGCATCATATACGTCTATC	CGGaCCCGGGCCGCGCTGG	AACCGCGGACCCGGGCCGCGCTGGCGGTAC	CCNA2_p.T46A
TTTGTCGCTCATAGCATCTACGA	GGGTGaGCAGACAGTTGTG	ACAGTGGGTGAGCAGACAGTTGTGCGGAGC	SBF2_p.E938G
TTTGCGCATATCTATCATCGTCA	AAAGaGCCTGGGGCAAGGC	ATCGGAAAGAGCCTGGGGCAAGGCTGGAGG	C14ORF177_p.E5G
TTTGGTCATCATGTGCATCATCT	TCCaTGAGGAACATACAAG	ATGTGTCCATGAGGAACATACAAGAGGTAC	AKAP9_p.H1784R
TTTGCACACTAGCAGTATATCAT	CTACaGCAGGCGAGGAGTC	CTGCTCTACAGCAGGCGAGGAGTCAGGCTT	MYO7A_p.001
TTTGTCACATCATCTATCGCGTA	CTACaGCAGGCGAGGAGTC	CTGCTCTACAGCAGGCGAGGAGTCAGGCTT	MYO7A_p.001
TTTGGAGAGTCATCACTATCTCT	TGAaTGGAGATGTTCGAGT	GACAGTGAATGGAGATGTTCGAGTGGGACT	WHSC1L1_p.N1238S
TTTGTCGTCATCGCAGTATCTAT	CAGGGaAAAGCCAGGAGAC	GTACCCAGGGAAAAGCCAGGAGACTGGAAA	ARHGAP25_p.E421G
TTTGACATCTCACTACAGAGTAC	AGAaTTGTGGAAGTGTCAG	AAACAAGAATTGTGGAAGTGTCAGAGGAGG	REL_p.N194S
TTTGGTCAGACAGAGTCTATCTA	CTGaTGTGCCATTGCGGAA	TACTGCTGATGTGCCATTGCGGAAAGGGCG	DSG2_p.M634V
TTTGTAGTATATCTATCATCACT	CCACCaCCAACGCCTTCTT	GGCCGCCACCACCAACGCCTTCTTCGGCTA	SRCRB4D_p.T240A
TTTGGAGTCTCTATCGTCATACT	TCCaGGGCTACTGACTTAG	CACTTTCCAGGGCTACTGACTTAGGGGAGC	TSC22D1_p.R161G
TTTGAGTGTCATCATAGTCATCA	TGCCCaTCTCGGAGACAGG	CACACTGCCCATCTCGGAGACAGGCGGAGG	TPO_p.I884V
TTTGGTCTAGTACAGTATATCAG	CCTCaGTTTCTATCCCCTC	AAGTGCCTCAGTTTCTATCCCCTCAGGTCA	TNRC6C_p.Q1111R
TTTGTATATCATACATATAGTCT	TTGaCCTGTCAGATATCCC	TGAAGTTGACCTGTCAGATATCCCTGGGGC	TTN_p.D21067G
TTTGCATGTATCATCTACTCTAC	GGGaAGCACGTGGTGCTGA	AAGTGGGGAAGCACGTGGTGCTGACGGAGC	CACNA1E_p.K1017E
TTTGTATATCATAGCAGTCTATC	GGGaAGCACGTGGTGCTGA	AAGTGGGGAAGCACGTGGTGCTGACGGAGC	CACNA1E_p.K1017E
TTTGTACATCTCTACAGTCTATC	CCCAGaAGGCGACGATGAC	GTGTCCCCAGAAGGCGACGATGACCGGACT	CLU_p.E329G
TTTGATCACTATCATGTCAGTAT	CCCTaTACTCAGGGATCCC	ACTACCCCTATACTCAGGGATCCCAGGATT	FAM5C_p.Y691C
TTTGTCGTCAGTATCGTCATACT	AGCaGTTTGTGAAAGGACA	CGAAGAGCAGTTTGTGAAAGGACACGGTCC	C12ORF65_p.Q63R
TTTGGAGCAGTCAGTAGTCATCG	TAaAACCAAGACATGACTC	TAAAATAAAACCAAGACATGACTCTGGAAT	FMN2_p.K1850E
TTTGCATATCTATCGTCATCTAT	TAaAACCAAGACATGACTC	TAAAATAAAACCAAGACATGACTCTGGAAT	FMN2_p.K1850E
TTTGACACAGTATCATATAGATC	GATaCTGTTCTCTGGAACC	CTGAAGATACTGTTCTCTGGAACCCGGAGC	ZNF641_p.T192A
TTTGCAGAGAGCATCGCTATCAT	AGAGGaGGAAGCCGCGGGC	GACCTAGAGGAGGAAGCCGCGGGCCGGAGC	NKX3-2_p.E140G
TTTGCTGTCATCGTCAGCAGTAG	CCTCCaCAGGGCTTGGCTG	CCCAGCCTCCACAGGGCTTGGCTGGGGGTC	NBEAL2_p.T325A
TTTGGTGTCACGTCATCTACTCT	AAGTaCCCCATCGTGTGGC	AGCAGAAGTACCCCATCGTGTGGCAGGGCC	SPEN_p.Y3505C
TTTGGCAGAGTGTCTATAGCTAT	AGGGaTCCCGGTGTCAGGT	ATACGAGGGATCCCGGTGTCAGGTGGGAGT	LPA_p.D776G
TTTGAGATCAGTACAGTATCTAG	AGTGaTGGCCGTCGGACTG	GTGGTAGTGATGGCCGTCGGACTGTGGGTA	SLC5A1_p.M40V
TTTGCATATCATCTCATAGCACG	CCGGCaTGACCAGTCAGGG	AACGTCCGGCATGACCAGTCAGGGAGGGGC	ATXN7_p.H772R
TTTGCGCATCATCATGTCTAGAT	GCTGGaCAGTGGACATCAC	AAATGGCTGGACAGTGGACATCACAGGAAA	TLR5_p.T239A
TTTGGTCATCTGTCGCTATCATA	TCGGTaCATCAGGGGGAAT	TAGAATCGGTACATCAGGGGGAATAGGTGA	UPP2_p.T147A
TTTGATCTATCATCTACAGTAGT	CAGAaCCATAGGCCTGGGG	ACTTCCAGAACCATAGGCCTGGGGAGGCGA	ZNF646_p.N869S
TTTGTGTATCACTATCTAGTACT	GAACaCATTAGGAAACTGC	TGCCAGAACACATTAGGAAACTGCAGGTAA	LRRIQ4_p.H393R
TTTGTCATCACAGTAGCATATAG	TGGaGCAGCTCTTCGGGCT	CCAGGTGGAGCAGCTCTTCGGGCTGGGTCT	TNK2_p.E1044G
TTTGGATATCACGTCATCTATAC	GGaGCTCCTGCTGGTGGGA	GAGCGGGAGCTCCTGCTGGTGGGACGGTAC	SLC5A10_p.E341G
TTTGCTGTGTAGTCATCATCTAC	AATGaGCAGGCCAGTGTGG	TGAGAAATGAGCAGGCCAGTGTGGAGGAGC	ZNF407_p.E1472G
TTTGGACTCTATCGTCAGCTATC	GGCGCaTGGTGATGTCTCG	AAAGGGGCGCATGGTGATGTCTCGAGGTGG	NOL6_p.M1105V
TTTGTAGTCTCATAGTCATCTAT	CGCTaCTGGCTCAGCCTGG	TGTCGCGCTACTGGCTCAGCCTGGGGGTGC	ST8SIA5_p.Y288C
TTTGATGAGTCTATCAGCATCGA	CAGTaTCCAGGGCCCAGCC	ATGATCAGTATCCAGGGCCCAGCCAGGTGA	SARDH_p.I113V
TTTGAGTGTGCATCTATCTCTAC	ATCaGCATCCTCCCCAGCA	GCACCATCAGCATCCTCCCCAGCAAGGTGA	IFT140_p.S585G
TTTGCTATATCGCATCTCACGTA	ATTGaGCCACAGACGGTGC	TGTCCATTGAGCCACAGACGGTGCAGGAGG	KIRREL_p.E230G
TTTGCATATCATCTAGATCAGTA	AATGaGGTTCTCAGAGGCT	TGGTCAATGAGGTTCTCAGAGGCTTGGACA	PLUNC_p.E229G
TTTGATCATCTACTATGTATCTA	AGATGaTAAGCGCTAGCAA	CCTTCAGATGATAAGCGCTAGCAAAGGTGA	RYR3_p.I3634V
TTTGGCAGTATCGTCTACTATCG	GCGaGCCGTGCGGGGGTGG	CGAGGGCGAGCCGTGCGGGGGTGGCGGCGC	IGFBP7_p.E69G
TTTGACTCAGTATCTACATCATC	TGaCCTGCCGCCACGGCTA	TTTAGTGACCTGCCGCCACGGCTATGGGAA	CDK14_p.D403G
TTTGTAGAGCACTATCATCTATA	CCATGaCAAGCTGCTTCTG	TACTTCCATGACAAGCTGCTTCTGGGGGAT	ZBTB9_p.D75G
TTTGATCTCATGTGTATCATCAC	TTGCTaAAGGATTTTGGGC	TAGTTTTGCTAAAGGATTTTGGGCCGGAGT	CEP350_p.K2523E
TTTGGTGTCAGACAGTATATCTA	CACCTaTCAATGACCTTCC	GGTCACACCTATCAATGACCTTCCTGGTGC	ADD3_p.I119V
TTTGAGTCATAGCATCACTATCT	TTGaGAAAAAGTGTGGGGA	GGAGCTTGAGAAAAAGTGTGGGGAAGGCAC	TRIML2_p.E145G
TTTGTCTCATGTCTATCACTAGC	TTGaGAAAAAGTGTGGGGA	GGAGCTTGAGAAAAAGTGTGGGGAAGGCAC	TRIML2_p.E145G
TTTGTCTCGTCGCATCTAGCATC	AGATaCTTCTATAACCAGG	TGGACAGATACTTCTATAACCAGGAGGAGT	HLA-DRB1_p.Y59C
TTTGATACAGTCAGTATCGCAGT	AGAGGaGGTATTGCAGGAG	AACTTAGAGGAGGTATTGCAGGAGTGGGAA	RCOR3_p.E339G
TTTGAGTCATCATGTCTAGAGTC	AAGaCTTAGCCTGGAAGCA	TTACAAAGACTTAGCCTGGAAGCATGGAAA	PCMTD1_p.D53G
TTTGGTCTATCAGCACTAGCTAT	TCCTCaCACCCGAAGCACT	GAACATCCTCACACCCGAAGCACTTGGCCT	PTCH2_p.T128A
TTTGGTCTCATCATCATCACTGT	TCCTCaCACCCGAAGCACT	GAACATCCTCACACCCGAAGCACTTGGCCT	PTCH2_p.T128A
TTTGCACATGTCATCGTCTAGCG	GGACTaTGAGTATGGGTCC	GATGCGGACTATGAGTATGGGTCCCGGGGA	TMEM198_p.Y342C
TTTGTGTATCTACATCTAGTACA	CGTGaGGAGTTTACAAGGT	ACCTTCGTGAGGAGTTTACAAGGTAGGCCA	EPB41L4B_p.E174G
TTTGGTCATCTACAGTCAGTATC	AGaTTGTTGTTATAATGAG	GTTTCAGATTGTTGTTATAATGAGAGGATT	YLPM1_p.I1640V
TTTGGATCACAGTATCGAGTATA	AGGaGTGTTATTACCACTG	GGACGAGGAGTGTTATTACCACTGGGGACG	REXO1_p.E993G
TTTGTGTCATCATATCATCGTAT	AAGAaTGCTGAAAGTAGCA	TTGAAAAGAATGCTGAAAGTAGCAAGGTTT	CLIP1_p.N801S
TTTGCACTCGTCATCTCATACTA	AGAaaTTTGTAGAGACCCC	TGCTAAGAAATTTGTAGAGACCCCTGGCCA	SSB_p.K166K
TTTGTCTGTCAGTAGTCAGCTAT	AGTCCaGTCCTTGTACAGT	CTGCAAGTCCAGTCCTTGTACAGTAGGGGG	ZNF804B_p.S659G
TTTGCATGTATATCAGTCTATCT	TGGaTCTTCCAGGCCATAA	GGGAGTGGATCTTCCAGGCCATAAAGGTGA	HPN_p.I400V
TTTGGCTATCAGCATCTACTATC	TGGaTCTTCCAGGCCATAA	GGGAGTGGATCTTCCAGGCCATAAAGGTGA	HPN_p.I400V
TTTGATGTATATAGCATATCTAC	GTGaGCCCTGCAACAGCGG	CTGGGGTGAGCCCTGCAACAGCGGAGGGGC	C9ORF91_p.S241G
TTTGCATCTATCATCTACAGAGC	CTCaAGAAGACGGGGCAGC	AGAAACTCAAGAAGACGGGGCAGCTGGACG	SMAD3_p.K43E
TTTGGTCTCAGATCTATCTATCT	GGGAaCCACACAGAGAATG	ATGGTGGGAACCACACAGAGAATGTGGGAG	LRRFIP1_p.N394S
TTTGTATGCATCTAGCATCATAC	GTGGaGACAGAAGTGGGGG	CTATGGTGGAGACAGAAGTGGGGGTGGCTA	TAF15_p.G448G
TTTGGCTATCATCGCTCATCACA	CAGaTGGGTAAGCTGGGGC	GGAACCAGATGGGTAAGCTGGGGCTGGGGT	GOLGA2_p.M446V
TTTGCAGCACATATCATACGTAT	CTACaCCTGGGTGCCTATA	CGGAACTACACCTGGGTGCCTATAAGGAGC	CACNA2D2_p.T626A
TTTGTCACTATCATCGCATCTAG	AGaCTCTGCACCCAGATTT	TCTGAAGACTCTGCACCCAGATTTAGGGAC	LDHA_p.T213A
TTTGTAGTACATCATGTCAGATA	GTGGaGTGCAGCACCCAGA	GAAGGGTGGAGTGCAGCACCCAGATGGATT	ADAMTS12_p.E1339G
TTTGTATCATGTGTCATCTCGTC	CCCaTGGACGTTCGCCAGT	CTGCACCCATGGACGTTCGCCAGTGGGTTG	RPA2_p.M102V
TTTGTACACTATCATAGTCAGCT	GCAaCTGACGACTATGGGA	TTATTGCAACTGACGACTATGGGAAGGGAC	PCDH15_p.T1225A
TTTGGCATAGCATCATCATATCG	CAGaTCAAACGCCAAGAGA	TGACACAGATCAAACGCCAAGAGATGGATT	HIP1_p.I976V
TTTGATATCATCACAGTATCTAT	CAGaTCAAACGCCAAGAGA	TGACACAGATCAAACGCCAAGAGATGGATT	HIP1_p.I976V
TTTGCTACATCTCAGCATATAGT	CAGaTCAAACGCCAAGAGA	TGACACAGATCAAACGCCAAGAGATGGATT	HIP1_p.I976V
TTTGATAGCATGTATCGTATCAC	CAGaTCAAACGCCAAGAGA	TGACACAGATCAAACGCCAAGAGATGGATT	HIP1_p.I976V
TTTGAGTCATCATCGCAGTCTCG	ACCaTGGTCCTGAAGCCTG	GGAACACCATGGTCCTGAAGCCTGCGGAGC	ALDH1A3_p.M201V
TTTGATAGTCATCACTAGTATAG	GGCTCaGTCTGCCTCCTTG	CCAAAGGCTCAGTCTGCCTCCTTGTGGAAG	INTS9_p.Q151R
TTTGCTATAGTCAGCAGTCTATC	CAAGaTAAACAGTCTGTGG	GCCTGCAAGATAAACAGTCTGTGGAGGAGA	CEP85_p.D553G
TTTGGATCATCAGCACTCTAGTC	AGGaGGTGATGCCGGGCAC	TGAAGAGGAGGTGATGCCGGGCACGGGCGC	TRIM47_p.R638G
TTTGTCAGCACATATCATGTAGC	CGCaTCGGCCACACAAACA	CAGCTCGCATCGGCCACACAAACATGGTGA	ANK1_p.I480V
TTTGCTATCAGAGTAGCATCATC	TTaCTGGCTGGGGGCCCCC	CAGGCTTACTGGCTGGGGGCCCCCCGGGAC	TBX21_p.Y385C
TTTGTATATCAGAGCATCTAGCA	TTaCTGGCTGGGGGCCCCC	CAGGCTTACTGGCTGGGGGCCCCCCGGGAC	TBX21_p.Y385C
TTTGACATACATCATCGCTCATG	GAAGaGAAGCCTAGATATC	CCTGGGAAGAGAAGCCTAGATATCTGGTGA	ZNF589_p.E27G
TTTGCATCACTCATCACGAGAGT	GGAGGaGCAACGGCAGCTG	GCCCAGGAGGAGCAACGGCAGCTGAGGCGG	TRIM58_p.E197G
TTTGACATACGTCTAGTATCATC	CTTTCaCCTGCCCCACGTG	GAAGCCTTTCACCTGCCCCACGTGCGGCAA	FEZF1_p.T401A
TTTGTATGTATCATCATCACTAT	GGTCTaGCGGTGCTTTTGG	TGGGGGGTCTAGCGGTGCTTTTGGGGGCAG	KRT24_p.S57G
TTTGTACATCATCATAGTCTCTC	GCCGaGTTGGATGACAAGC	CCCAGGCCGAGTTGGATGACAAGCAGGCGG	DNAH5_p.E3450G
TTTGTCATCACATATATCTACTA	AGCaCACGGCCGATAATTG	TCCAGAGCACACGGCCGATAATTGAGGGTT	NCOR1_p.T1374A
TTTGATCATCATGTCAGCATAGC	AGCaCACGGCCGATAATTG	TCCAGAGCACACGGCCGATAATTGAGGGTT	NCOR1_p.T1374A
TTTGGTCATATATCTCATAGTCT	AGCaCACGGCCGATAATTG	TCCAGAGCACACGGCCGATAATTGAGGGTT	NCOR1_p.T1374A
TTTGGTCTAGTATCACTAGTACT	AGCaCACGGCCGATAATTG	TCCAGAGCACACGGCCGATAATTGAGGGTT	NCOR1_p.T1374A
TTTGATCATCTCACATCATAGCT	GCCCaGGCCCCGTGGGTGC	TGGGTGCCCAGGCCCCGTGGGTGCCGGAAG	MAP3K11_p.Q838R
TTTGATATCGTCATACTCAGCTA	CCAaTGTAGATGCTCACAG	TTGGCCCAATGTAGATGCTCACAGTGGGGT	CS_p.N400S
TTTGTGTGTGTATCGTCAGTCTC	CCAaTGTAGATGCTCACAG	TTGGCCCAATGTAGATGCTCACAGTGGGGT	CS_p.N400S
TTTGTAGAGAGTCATATAGTATC	TCCaTGATCTGCATTTCCG	TTGACTCCATGATCTGCATTTCCGTGGTGG	MC5R_p.M121V
TTTGATACATCTAGTCATCATGA	CCGaCGTGGGTAAGACCTG	CGACCCCGACGTGGGTAAGACCTGGGGGGG	DCHS1_p.D1677G
TTTGACTATCGCACGTATCTACG	GCCCaGAGTGGACAGTTGG	TGGCCGCCCAGAGTGGACAGTTGGAGGCCT	ASB2_p.Q232R
TTTGGTCTCTACTACAGTATATC	CGCaTGCCATCTTGGCACG	GGTGCCGCATGCCATCTTGGCACGGGGGAG	SLC1A7_p.H4R
TTTGGTATCTAGTATATATCGCT	AAGaTGGTAGTGATGAAAA	CTGTGAAGATGGTAGTGATGAAAAAGGTTG	LRP1B_p.D1081G
TTTGAGATCATATGTCATATATC	AAGaTGGTAGTGATGAAAA	CTGTGAAGATGGTAGTGATGAAAAAGGTTG	LRP1B_p.D1081G
TTTGGTGTGTATCGCATCACTAC	AAGaTGGTAGTGATGAAAA	CTGTGAAGATGGTAGTGATGAAAAAGGTTG	LRP1B_p.D1081G
TTTGATGTACAGCATCATCATCT	AAGaTGGTAGTGATGAAAA	CTGTGAAGATGGTAGTGATGAAAAAGGTTG	LRP1B_p.D1081G
TTTGTCGCATCTAGTATCATCTA	TGGaTGGTGTCAAGTGTGT	GCTGCTGGATGGTGTCAAGTGTGTGGGCGC	C20ORF27_p.D177G
TTTGCAGTATCACTAGTATATAT	TGTTTaCGGAAATCAAAGT	GGACATGTTTACGGAAATCAAAGTTGGAGT	ADSS_p.T370A
TTTGTATAGCATATATATCATCT	AATaTGGTGAACGGCCGCC	AGCATAATATGGTGAACGGCCGCCTGGCAG	QSOX2_p.M510V
TTTGTGCATCATCTCTATGTATC	CATaTGATGAATGGGACTA	TGTATCATATGATGAATGGGACTATGGCCT	GRIN2B_p.Y282C
TTTGCTCAGAGAGATCATCTATC	AGGTGaCCATCGAGCCTGC	CGAGAAGGTGACCATCGAGCCTGCTGGCAA	DSCAML1_p.T1341A
TTTGCGTCTAGTATCATCTCGTC	AAGCaAGAATATAAGACAT	TACAAAAGCAAGAATATAAGACATTGGAAT	CFTR_p.Q378R
TTTGGTATATCAGAGAGTAGCTA	TCCaGGGGACAGCTGGCGT	GCTTCTCCAGGGGACAGCTGGCGTCGGGGC	DUOX1_p.R194G
TTTGAGTGTACATACGCATCGTA	CAGaAGTTGAGGAGAATGA	GAGATCAGAAGTTGAGGAGAATGATGGACA	C3ORF26_p.K243E
TTTGCTGCAGTGTATCGTCTACG	GCGCaCTTCCGGCGCCCAG	TCCCCGCGCACTTCCGGCGCCCAGTGGGCA	C6ORF120_p.H109R
TTTGTGCATCATCATCTATCTAC	CACaGCTTGACCCTCAGAC	AGCTACACAGCTTGACCCTCAGACGGGAGG	LILRB5_p.S559G
TTTGATGTCAGTCTACGAGTATC	CCCGGaGAGGCACCCGCGG	AGGCACCCGGAGAGGCACCCGCGGAGGCGC	ALYREF_p.R217G
TTTGCGTATAGTCAGTCAGTACT	AATaTAATGCTTCGAAGCA	ATGACAATATAATGCTTCGAAGCACGGGAC	PIK3C2A_p.I1256V
TTTGTGTGTGTCATCTATCGCAG	CGTaCGTGTGCCCCGAGTG	GAAGCCGTACGTGTGCCCCGAGTGCGGGCG	ZNF71_p.Y270C
TTTGATCGCATCATAGCTCATAT	AGTTaCTACCAGTGGCTGA	GTCGTAGTTACTACCAGTGGCTGATGGACA	IFT172_p.Y743C
TTTGAGAGAGCATCTAGTAGCTA	GCTaCGGAGGCTACGGATA	CGGTGGCTACGGAGGCTACGGATACGGCTC	KRTAP19-5_p.Y41C
TTTGATCGCATCATATCTATCTA	CTGTaCTGCGATGTGATGC	GGTTCCTGTACTGCGATGTGATGCTGGAGA	ZNF551_p.Y38C
TTTGCATGTAGCATCATATCTAC	TGCTGaAGCCACCCTAACA	GATGCTGCTGAAGCCACCCTAACATGGTAT	RALGAPB_p.E900G
TTTGGCTCATACATCATCATACG	GGCGaCTCTCTGGCAAAGG	GCCCCGGCGACTCTCTGGCAAAGGTGGGAG	SUFU_p.R299R
TTTGCGATCAGTACAGTATCATA	AGCaAGCGGACCACGCGAA	GCAGCAGCAAGCGGACCACGCGAACGGTGA	CACNA1D_p.Q17R
TTTGCATCATCATCATAGATAGA	GAaATCCTATCCAGACCAA	ACGAGGAAATCCTATCCAGACCAAAGGAGT	SKOR1_p.K723R
TTTGGTATCACTATATCGCATAG	GAaATCCTATCCAGACCAA	ACGAGGAAATCCTATCCAGACCAAAGGAGT	SKOR1_p.K723R
TTTGGAGTCTCTATCTACAGAGC	CACAaAGTGTATGAAGCGG	CCATCCACAAAGTGTATGAAGCGGTGGAGC	GEMIN5_p.K990R
TTTGATGTATATCTCAGAGTCTC	CACAaAGTGTATGAAGCGG	CCATCCACAAAGTGTATGAAGCGGTGGAGC	GEMIN5_p.K990R
TTTGTCTATCATCGTATCTCTAC	AGCGGaTTCCTACACAAGC	GGTTCAGCGGATTCCTACACAAGCAGGCCG	CACNB4_p.D19G
TTTGACGCATGTATATCATATAT	TATGaGTCTATATATCCTG	CTTACTATGAGTCTATATATCCTGGGGAAT	EPC1_p.E87G
TTTGGATATATCAGTATATCAGT	GTAaCCACAGAAGAATTTG	CCAGAGTAACCACAGAAGAATTTGAGGCCC	BOD1L_p.T2111A
TTTGGAGATAGTATCATCGTATA	AGAGaAGGGCGACTCGGGG	CCGGGAGAGAAGGGCGACTCGGGGCGGCCC	C1QL2_p.K108E
TTTGTATATATCATCGAGTCGCG	AGAGaAGGGCGACTCGGGG	CCGGGAGAGAAGGGCGACTCGGGGCGGCCC	C1QL2_p.K108E
TTTGACATAGTATATCAGTATCA	ATCaCCGAGAAATTCAGTG	AAGAGATCACCGAGAAATTCAGTGCGGAAC	PCNT_p.T879A
TTTGTGTCACTCAGAGAGCATAG	GACaCCGACCTTAAACAAG	TCTCTGACACCGACCTTAAACAAGAGGAAT	DMTF1_p.T658A
TTTGACACATACGTATCAGCAGT	GCCCaTAGCTAAGGACCCG	TCCTCGCCCATAGCTAAGGACCCGAGGTAT	SNTG2_p.I206V
TTTGATGACATCTAGTCAGTAGA	AATTaCATTAAAGAAAAGA	AACGAAATTACATTAAAGAAAAGAAGGCAG	SUDS3_p.Y128C
TTTGCAGATCATCTATAGTATAT	CCCaAAGCCACATCTCCAA	AGACACCCAAAGCCACATCTCCAATGGGTA	MUC16_p.K4010E
TTTGGTATCAGTCACTACAGTCT	ACCATaCAGGTAAGAAAAA	ATTTTACCATACAGGTAAGAAAAAGGGATT	NDST3_p.T356A
TTTGATGAGCATCATCTATCAGT	ACGACaGAGGAGCCGGGCA	CTGGCACGACAGAGGAGCCGGGCATGGCTG	RRP12_p.Q1103R
TTTGTGTGTACATCATCAGCTCT	ACTCTaTGGGATAGAGCGG	CCTGGACTCTATGGGATAGAGCGGCGGCGA	SMG9_p.Y12C
TTTGCTCTCAGTAGCATCATACG	GCTGCaGGGATCCAGCTGG	CAGATGCTGCAGGGATCCAGCTGGAGGGAG	RLTPR_p.Q828R
TTTGCATCAGTCACTAGTACTAT	TTGGaAGCCATGGATATGG	CACCGTTGGAAGCCATGGATATGGTGGAGG	IFNAR2_p.E297G
TTTGTACATCGTCAGCATCTCGC	CTAACaTTTGGCTAGAGTA	AGGTCCTAACATTTGGCTAGAGTATGGCCA	SART3_p.I185V
TTTGTCTAGTATATCACTACGAG	GTaCCCACTCAAGTGAGTA	CGAATGTACCCACTCAAGTGAGTAAGGGAA	ATP1A4_p.Y987C
TTTGGTCTATATCATCGCTATAC	TCCaGCAAGTGGTGACCTG	CTGGATCCAGCAAGTGGTGACCTGAGGAAC	TMPRSS6_p.Q807R
TTTGATGAGCACTATCATCTAGA	CCGaGGTATGCACGGCGTC	CTGGACCGAGGTATGCACGGCGTCCGGATC	FAM129C_p.E303G
TTTGTCTAGTCACTAGCAGTATC	GGGaGGCCTCAGTGAAGTA	TGTCCGGGAGGCCTCAGTGAAGTAAGGGGA	NLRC5_p.E1303G
TTTGTAGTCAGCATCGTCACTAT	TACaTTAAGGAGCTTCCAA	GGTGCTACATTAAGGAGCTTCCAAAGGGCT	DBH_p.I234V
TTTGCATCATATCAGTATCGTGC	TACaTTAAGGAGCTTCCAA	GGTGCTACATTAAGGAGCTTCCAAAGGGCT	DBH_p.I234V
TTTGAGTCATCTATCACTACGAG	CTGCCaGGCAGGTACGTGT	AAGGGCTGCCAGGCAGGTACGTGTGGGCTG	RRP12_p.Q674R
TTTGAGTGTCTCGTATCGCATAC	ATTAaGCAATGAAACAGAC	TCATCATTAAGCAATGAAACAGACCGGCTG	LANCL2_p.S311G
TTTGCAGTATCTCATGTCACTAT	CAGGaGGCAGATGAAGCCA	AAGTCCAGGAGGCAGATGAAGCCAAGGTGT	VARS_p.E1237G
TTTGCTGTATATGTATCATCGCG	CTACaGCCAGATGGAGAAC	AGCTCCTACAGCCAGATGGAGAACTGGAGC	PKP1_p.S121G
TTTGCATGTATCGCATCGCATAG	CATGGaGGACGGCAAGGGC	GGTGGCATGGAGGACGGCAAGGGCCGGAGG	DLGAP4_p.E175G
TTTGTCATCTCACAGCAGTCTAT	GTGTCaGAAGCGTGAACAC	GGAATGTGTCAGAAGCGTGAACACAGGTAA	ZNF610_p.R102G
TTTGATGTGTCATCATCGACATC	CAGCaGGGCAGCTTCAGTG	TTCTGCAGCAGGGCAGCTTCAGTGTGGATG	ZXDC_p.Q593R
TTTGAGAGCATCGCATCATACGA	CTGCaGGAAGAAATCGGCA	AGGTCCTGCAGGAAGAAATCGGCAAGGCCA	SIGLEC8_p.R388G
TTTGTGTATATCACAGAGTAGCA	AAaAGTGTCTAAACGACGT	TGTGAAAAAGTGTCTAAACGACGTTGGAAT	DEFB126_p.K26E
TTTGTGAGTGTCAGTATATCTAT	AAaAGTGTCTAAACGACGT	TGTGAAAAAGTGTCTAAACGACGTTGGAAT	DEFB126_p.K26E
TTTGCGTGTCATCACTAGCATCA	GTCTaTGACGATGGGCTGG	CAGGTGTCTATGACGATGGGCTGGAGGAAT	TAAR6_p.Y173C
TTTGGCATCACAGTATCTATAGA	GGCaGGCAGAAATGCTGAC	GGCCAGGCAGGCAGAAATGCTGACAGGTGG	MBD3L5_p.Q201R
TTTGGTCTACAGTCTATCATACG	GGCaGGCAGAAATGCTGAC	GGCCAGGCAGGCAGAAATGCTGACAGGTGG	MBD3L5_p.Q201R
TTTGCGAGCATCTAGTATCTACT	TATGaGGGAAGCCGTTAGA	AAACATATGAGGGAAGCCGTTAGAAGGTTA	TAF11_p.R188G
TTTGTGTCACTATATCGTCTAGT	GAaCCTAAAGCCCAACACG	ATTGAGAACCTAAAGCCCAACACGAGGTAC	FNDC1_p.N1719S
TTTGATACGTCATCTAGTATCTC	GAaCCTAAAGCCCAACACG	ATTGAGAACCTAAAGCCCAACACGAGGTAC	FNDC1_p.N1719S
TTTGTGTATCGTGTAGCATCATA	CAAaCTTTATAGATGGGAT	AGAGCCAAACTTTATAGATGGGATCGGGAT	RANBP2_p.K2939K
TTTGCATCATGTCATCTCGACGC	GGACaGGTGACCGACCAGG	CCTTGGGACAGGTGACCGACCAGGTGGAGG	CALD1_p.Q61R
TTTGTAGATCTATATCTATCGCA	ACGGCaCTGTCATCCCCAA	GCCCGACGGCACTGTCATCCCCAACGGCTA	DPF1_p.T223A
TTTGAGTCGCATCGTCTATAGAG	ACTaGGCTGATGAAGGATT	CGCCCACTAGGCTGATGAAGGATTTGGGCT	WRNIP1_p.R624G
TTTGGATCATCATCTCGACTATC	AAAaCCTGCACCCAGAAGG	GGCCAAAAACCTGCACCCAGAAGGAGGTAT	PPP2R5B_p.T327A
TTTGGTACATATATCTCATACGT	AGCCAaAGAACTGCAAACT	AGCAAAGCCAAAGAACTGCAAACTTGGGAG	LIPT1_p.K264R
TTTGCTATCATCACTCAGCATCG	AGCCAaAGAACTGCAAACT	AGCAAAGCCAAAGAACTGCAAACTTGGGAG	LIPT1_p.K264R
TTTGTACAGTCTAGTATCTAGAT	GCAGaaCTAGTGCCAGGGG	AGGCAGCAGAACTAGTGCCAGGGGTGGCTG	PRX_p.E1037E
TTTGCACATCATGTCAGCATCAT	CTCTaTCCTGGGCAGTTCA	AGGAACTCTATCCTGGGCAGTTCAAGGTGA	SIRT2_p.Y139C
TTTGACTCATCATCTCATCACGT	GCGCGaGTCGGAGCCCCCG	AGAGGGCGCGAGTCGGAGCCCCCGGGGAGT	SORCS1_p.S125G
TTTGGTATCGTCATCTATCAGCT	CTGGaGGAGGCCTGCCAGT	TGGGGCTGGAGGAGGCCTGCCAGTTGGCTC	NUDT2_p.E120G
TTTGCGTGTCATCAGCATCTGCG	GCGGaGGAGGCCGCGCCGG	CGCTGGCGGAGGAGGCCGCGCCGGAGGTAG	FBXO21_p.E18G
TTTGCAGAGCATCATATCTATCA	GGGGaCCTTATAACTAAGA	CAGGCGGGGACCTTATAACTAAGACGGCTC	TOR1B_p.D219G
TTTGCATCATGTCACATACGCTA	GGAGTaTGAGGTAAAGCCC	CAGAAGGAGTATGAGGTAAAGCCCTGGGCT	VPS16_p.Y356C
TTTGTATCATCATCTAGCGTATA	GGAGTaTGAGGTAAAGCCC	CAGAAGGAGTATGAGGTAAAGCCCTGGGCT	VPS16_p.Y356C
TTTGATACACTAGTATCAGCATC	GAAaGAGAAATGTTACTTA	TGGAAGAAAGAGAAATGTTACTTAAGGCAG	TAF4B_p.R745G
TTTGCACGTCTATCATAGCATCA	GAAaGAGAAATGTTACTTA	TGGAAGAAAGAGAAATGTTACTTAAGGCAG	TAF4B_p.R745G
TTTGACATATCAGCATCTAGCAG	AAATGaCAGTCAGCCTCCC	AGAGAAAATGACAGTCAGCCTCCCAGGACC	ZP2_p.T653A
TTTGGTCATCATGTCACATATCA	AAATGaCAGTCAGCCTCCC	AGAGAAAATGACAGTCAGCCTCCCAGGACC	ZP2_p.T653A
TTTGGACAGAGTCTCATCATCGC	TGCaGGCAACAACTATGTC	GACACTGCAGGCAACAACTATGTCCGGGAA	SLC15A1_p.Q307R
TTTGAGTCACTAGTATATCATCA	TCCATaGGTGGGTGAGGGC	CAGCATCCATAGGTGGGTGAGGGCGGGCGG	PRAM1_p.I477M
TTTGGTATCATCACAGCATAGTC	TGGATaTATCATCATGTTC	GGATTTGGATATATCATCATGTTCCGGCCA	CNTN6_p.Y736C
TTTGCGCATCGTCATCACTACGC	AGATGaAAAAGTCTCCTGT	AAATAAGATGAAAAAGTCTCCTGTGGGTAG	ARHGAP32_p.K304E
TTTGGATCGTCAGCATACATCAT	GCCCaGGAGAAAGCCAAAA	TGAAGGCCCAGGAGAAAGCCAAAAAGGAGC	HYDIN_p.Q2227R
TTTGACATCGTCAGTCTCTACAG	GTGTGaCCATCGCGCAGGG	GGGGCGTGTGACCATCGCGCAGGGTGGCGT	HIST1H2AB_p.T102A
TTTGGATAGTCATCATCTACAGC	GGTTGaCAACCCTAAGAAC	GTGCTGGTTGACAACCCTAAGAACCGGATG	ITGB4_p.D1276G
TTTGGAGTCAGCATCTACGTATA	CAaTCCAGCCACAGGAGAA	ATCATCAATCCAGCCACAGGAGAATGGAAG	DNAH9_p.N2195S
TTTGATGTCTCGTCTATCTACGA	TAATaTTAATGTTAGAAGT	CAGTGTAATATTAATGTTAGAAGTTGGTGA	NCAPD3_p.I307M
TTTGGTGCATCTATCGTCAGATC	AGCAaTGGTTCTGTGCCAA	ATTCCAGCAATGGTTCTGTGCCAAAGGAGA	CGNL1_p.N90S
TTTGTGTATCATCTACAGAGCAT	AAAaCTCTGGAGCACAAGG	AAGACAAAACTCTGGAGCACAAGGAGGTGG	MAP1A_p.T1373A
TTTGTCATCAGTCTATCGAGAGC	AGGaAGAAGAAGGGGAGCG	GAAGCAGGAAGAAGAAGGGGAGCGCGGGCG	PNMAL2_p.K592E
TTTGCTCATCTCACTAGTATCTA	AGGaAGAAGAAGGGGAGCG	GAAGCAGGAAGAAGAAGGGGAGCGCGGGCG	PNMAL2_p.K592E
TTTGTATCTACATATATCAGATC	GAGGaGGTCTTCCTGGACC	TGCTGGAGGAGGTCTTCCTGGACCTGGAGG	EXOC3_p.E545G
TTTGTCTATCTACTATCTATCTA	ATCaTGCTTCTGGCGCTGG	ATGCCATCATGCTTCTGGCGCTGGTGGTGT	GPR37L1_p.M134V
TTTGAGTGTGTATCGTCATCATA	GATCaGGACGGCTGGATTC	ACACGGATCAGGACGGCTGGATTCAGGTGT	PDCD6_p.Q172R
TTTGGTCACTATCATCGCATCAT	CTTGaTAAGTCTGGAAGCA	TAGTTCTTGATAAGTCTGGAAGCATGGGGG	CLCA4_p.D25G
TTTGACACAGTACGTATCAGCAG	GGGaCCGGCCTGTTGGAGG	ATGGGGGGACCGGCCTGTTGGAGGAGGCCC	FASTK_p.D70G
TTTGTATATCACTATCATCGTAT	ACCaTGTGAGGTCTCATGA	GACTTACCATGTGAGGTCTCATGAAGGAGG	VEZF1_p.H220R
TTTGAGCATCTGTATCAGTATAT	CAaTTGAGGACCTGCAGGT	AGTGACAATTGAGGACCTGCAGGTAGGTAG	CPA4_p.I91V
TTTGGTCTACAGTCTCTAGTACG	CTGAaGCAAGAAGAAACCT	TTTCCCTGAAGCAAGAAGAAACCTTGGACT	NEUROD6_p.K274R
TTTGTGTCATATGTCATCATCGT	GGGGGaCATCCAGGAACCT	CTTTTGGGGGACATCCAGGAACCTGGGCAC	WFDC6_p.D18G
TTTGTCTATCTAGATCATATCGC	GATTaCGTGGGCAGCCCCG	TGGAGGATTACGTGGGCAGCCCCGTGGTGG	NTF3_p.Y123C
TTTGCACAGTATGTCTAGTATCG	CCCaATTTCCCGGGACCAA	ACGGCCCCAATTTCCCGGGACCAAGGGGGC	DIDO1_p.N1770D
TTTGAGTGTATCTATCATCGAGC	GCAGaAGGCACACAGGGAC	CACACGCAGAAGGCACACAGGGACAGGACG	PARVG_p.K319E
TTTGGTGATCATCTATCACGAGT	GCCAaAAGATCAAAAGAAC	AGTCAGCCAAAAGATCAAAAGAACTGGAGA	GNAT3_p.K14R
TTTGGAGTCATCTCAGCGTATCG	GCCAaAAGATCAAAAGAAC	AGTCAGCCAAAAGATCAAAAGAACTGGAGA	GNAT3_p.K14R
TTTGCAGTCAGACAGTCAGTCAG	ACAGaGGACGATGTGGAGC	TCTTCACAGAGGACGATGTGGAGCAGGCAG	KMT2D_p.E1267G
TTTGTCTCTATCATCTAGTCAGT	GCGCCaCTGAGCCAGAGTT	GCTTAGCGCCACTGAGCCAGAGTTGGGTGA	MST1R_p.T286A
TTTGCATCATCATCACTAGAGAG	GGAGaGTGGTGATCGGATA	CGTCTGGAGAGTGGTGATCGGATAAGGACG	MYOM3_p.S1263G
TTTGCTATCGCATCACTATCATA	GGAGaGTGGTGATCGGATA	CGTCTGGAGAGTGGTGATCGGATAAGGACG	MYOM3_p.S1263G
TTTGGATATCAGAGTCGCATAGC	GAAGaCTACATTTGGTTCC	CTTGGGAAGACTACATTTGGTTCCAGGCAC	MAD2L1BP_p.D259G
TTTGTATCATATAGTCATACGTC	AACaGAGCGAAGGAATCTG	AGGAAAACAGAGCGAAGGAATCTGAGGTTC	RASSF9_p.R381G
TTTGAGTAGCATCATCATATCTA	GTATaTTTGAACCTGCTAA	GGATAGTATATTTGAACCTGCTAAGGGAGG	ADAR_p.I939M
TTTGACATCACAGTAGCATCGTC	ACTGCaAGCGTCTGGTGAC	CTGCTACTGCAAGCGTCTGGTGACAGGACA	LAMB1_p.K482E
TTTGCATCATGTCACTCATCTCA	AAGAaGAGGCCGGAAGACG	ATTGTAAGAAGAGGCCGGAAGACGGGGAGG	ZNF521_p.K33R
TTTGCTCATCTCATACGCATCTA	AAGAaGAGGCCGGAAGACG	ATTGTAAGAAGAGGCCGGAAGACGGGGAGG	ZNF521_p.K33R
TTTGACTATATCATCGCATACTC	AAGAaGAGGCCGGAAGACG	ATTGTAAGAAGAGGCCGGAAGACGGGGAGG	ZNF521_p.K33R
TTTGCATACAGTATCATCTACGA	AAGAaGAGGCCGGAAGACG	ATTGTAAGAAGAGGCCGGAAGACGGGGAGG	ZNF521_p.K33R
TTTGATATCTCGTCATCTACGAC	CCGGTaAGGGCATGGGGAT	AGGAACCGGTAAGGGCATGGGGATGGGAAG	C6ORF25_p.001
TTTGTGATCATATGTATCATATC	GAGCaGGATGCTCAGGACC	GCAATGAGCAGGATGCTCAGGACCTGGACA	DUSP10_p.Q335R
TTTGCTAGTCATATATCTATCGA	GCGTGaGCGCCACAGACCG	GTTCCGCGTGAGCGCCACAGACCGCGGCTC	PCDHB16_p.S532G
TTTGGTGTATATCAGCACTAGTC	ATGAaTGGGGAAGAATGTG	GTGAAATGAATGGGGAAGAATGTGCGGAGG	IKZF1_p.N74S
TTTGATCATACAGTATCATCATC	ATGAaTGGGGAAGAATGTG	GTGAAATGAATGGGGAAGAATGTGCGGAGG	IKZF1_p.N74S
TTTGGAGCACATATCATATCGTG	ATGAaTGGGGAAGAATGTG	GTGAAATGAATGGGGAAGAATGTGCGGAGG	IKZF1_p.N74S
TTTGATACATCATCGTCAGAGTA	ATGAaTGGGGAAGAATGTG	GTGAAATGAATGGGGAAGAATGTGCGGAGG	IKZF1_p.N74S
TTTGGACAGCATGTCATCTCGTC	CTTaTTATTAGAAGTGATC	GGACCCTTATTATTAGAAGTGATCAGGCGC	FGFR1OP_p.L127L
TTTGCTCAGATCTATCGCTATAT	GAAaGTGGACAGTATCAAA	ATCATGAAAGTGGACAGTATCAAATGGAAC	RFTN2_p.S219G
TTTGCGAGTCAGCATCTCTACAT	GATGGaGCAGCCACTGGAG	AGAAGGATGGAGCAGCCACTGGAGTGGATG	MUC16_p.G12762G
TTTGGTCATCTCTACAGAGTAGC	AGTaCATTGTGAAGTGCCA	ACTGTAGTACATTGTGAAGTGCCATGGCAA	PIP4K2C_p.Y172C
TTTGACATATCATATAGTACATA	CAACaGGTGACTGGCTTAA	CCGCACAACAGGTGACTGGCTTAATGGTGT	EPHA3_p.T916T
TTTGGTCATCATCATAGTCTCAG	CAACaGGTGACTGGCTTAA	CCGCACAACAGGTGACTGGCTTAATGGTGT	EPHA3_p.T916T
TTTGTCATGTCATCGTCATACTC	TTTCAaCGAAATAAATGCC	CAACTTTTCAACGAAATAAATGCCCGGAAA	ATP2B1_p.N986S
TTTGAGATCATCTATAGTCAGTA	TTTCAaCGAAATAAATGCC	CAACTTTTCAACGAAATAAATGCCCGGAAA	ATP2B1_p.N986S
TTTGCATCATATCATCACATATG	TATGaGCTGTACAACCCAA	TCCAGTATGAGCTGTACAACCCAATGGCCT	GANAB_p.E288G
TTTGGATCATCTACATCACTAGA	GCTTCaCAGCAGCACAGAT	ACAAGGCTTCACAGCAGCACAGATGGGCAA	TNKS_p.T626A
TTTGGAGAGATCAGTAGCATATA	GTGGaCGCAGAGGGGATGG	GGTGTGTGGACGCAGAGGGGATGGAGGTGT	TG_p.D142G
TTTGTGTCTATCATCACAGAGCT	CCCTaTGTTGGCGGGCTGG	GCCGGCCCTATGTTGGCGGGCTGGAGGAGT	TEP1_p.Y1088C
TTTGATCAGTCTACGAGTCTAGC	GGAaCAAACAGATAGCCAT	TCAGAGGAACAAACAGATAGCCATGGGAAG	CYTH3_p.N67S
TTTGATATATCAGCATCTAGTAT	GTTCaCCATACCCTTGAAC	AGGGAGTTCACCATACCCTTGAACAGGCCG	SBSN_p.H463R
TTTGGCATGTCATCACTAGTAGT	ACAACaAACAGGTGAGCCT	GCACCACAACAAACAGGTGAGCCTTGGAAC	EEF1G_p.K125E
TTTGTCACTATCATCATCGACAT	GGCCaCAGGAACTCATGTC	TATCTGGCCACAGGAACTCATGTCGGGAAA	WDR61_p.T123A
TTTGTCGTCATCATATCATCGCA	TGGaGCTATCTGAATACAG	ATGGCTGGAGCTATCTGAATACAGTGGAAA	KLHL1_p.S565G
TTTGTATCACTGTATCGTATCAC	TGGaGCTATCTGAATACAG	ATGGCTGGAGCTATCTGAATACAGTGGAAA	KLHL1_p.S565G
TTTGACTCATCTCACTATAGCTC	GTTTCaCTGCAAATAAACC	CTACTGTTTCACTGCAAATAAACCAGGCAA	ALG8_p.T220A
TTTGCACTATCTATCACTACATC	GCTGaGCGGATCAGACCCA	GCTTTGCTGAGCGGATCAGACCCATGGTCC	ADSSL1_p.E269G
TTTGATAGTCAGAGCATCATACG	TTGCaGAGAGAATACGTGA	TCATGTTGCAGAGAGAATACGTGAAGGTAC	PRPF18_p.Q259R
TTTGCTAGTATCATCGTCAGTCT	TGGaGAGATGTGACATGGA	CAAAGTGGAGAGATGTGACATGGATGGGAT	LRP1B_p.E352G
TTTGTGTATATCAGCATCTACTA	TGGaGAGATGTGACATGGA	CAAAGTGGAGAGATGTGACATGGATGGGAT	LRP1B_p.E352G
TTTGCTGTCTCACTAGTAGCTAT	TGGaGAGATGTGACATGGA	CAAAGTGGAGAGATGTGACATGGATGGGAT	LRP1B_p.E352G
TTTGTCAGCACTACATATATCGC	TGGaGAGATGTGACATGGA	CAAAGTGGAGAGATGTGACATGGATGGGAT	LRP1B_p.E352G
TTTGGACATCATATCAGTATAGC	GAGaGGGGTCAGAAGCTTG	TCGCTGAGAGGGGTCAGAAGCTTGAGGATT	SPTA1_p.R45G
TTTGTAGTAGTCATATATATATC	ACCaTGGTGAGGAGCAGCT	CTGGCACCATGGTGAGGAGCAGCTGGGTCC	SLC25A39_p.M100V
TTTGACTATCACAGCATACTATA	GACTaCGGGAAGCTGCGGA	TGATTGACTACGGGAAGCTGCGGAAGGTAT	ACTN1_p.Y193C
TTTGTCTCAGATCAGTACGTAGC	TATaTAGTTTCATAAAGGA	TCCACTATATAGTTTCATAAAGGAAGGAAA	ANGEL2_p.Y361C
TTTGACTCACATACGTCATCATA	CTCCaAACCGCCCCGAGAC	CATCTCTCCAAACCGCCCCGAGACTGGTTC	DIP2C_p.K371E
TTTGTCAGTATATATCATGTATC	TTCTaACTGCCAAACTGGT	ATTGGTTCTAACTGCCAAACTGGTAGGTAA	VWDE_p.N1324D
TTTGAGTATCAGATCAGTATATA	TTCTaACTGCCAAACTGGT	ATTGGTTCTAACTGCCAAACTGGTAGGTAA	VWDE_p.N1324D
TTTGGCAGTCTATCTACGTATCG	TGAaGCAGGTGCAGACCAG	CTTCATGAAGCAGGTGCAGACCAGCGGCGT	KIAA1244_p.K699R
TTTGTGTATATCATAGCATCTAG	AGCaCCAGAGGGTCCACAC	GAGGAAGCACCAGAGGGTCCACACTGGAGA	ZNF16_p.H395R
TTTGTGTCAGCATCTACGTATCT	TGGaTGAAGGCTTGATCCC	GGTGGTGGATGAAGGCTTGATCCCTGGAGA	GTF3C1_p.D1105G
TTTGTCAGTCGCAGTATAGTCTC	AGGGaCCTTGTAGACTACC	AGCACAGGGACCTTGTAGACTACCTGGACC	ANKS6_p.D272G
TTTGAGCATAGCATCTATCGCTA	AGATGaGTAAGGGAAGCCT	TGAGAAGATGAGTAAGGGAAGCCTTGGAAT	SCP2_p.S125G
TTTGATCAGAGTCTCATACGTCT	TTCCaCCTGAGGGTGTTCA	GGCGTTTCCACCTGAGGGTGTTCATGGAGG	ZP1_p.H111R
TTTGTAGTCAGTATCTCAGAGTA	GCAGaCGATCATTGAGGTG	CTGGGGCAGACGATCATTGAGGTGCGGACG	UNC13A_p.T768A
TTTGATCTATCGTCTATCATCAC	AGAGGaCACTATGTCTGGA	GAGGCAGAGGACACTATGTCTGGAGGGAGT	PRKAG3_p.T425A
TTTGAGTCTATCATACGCATCAT	TAGTaCGTGCAGAGGCCTT	CCAGGTAGTACGTGCAGAGGCCTTTGGCAT	FGFR4_p.V442V
TTTGGATCTATCATCATCATATC	ATCaTCCCGACAAGAATCC	GCGGTATCATCCCGACAAGAATCCAGGGAA	DNAJC5G_p.H61R
TTTGATGTCATCATCGCATCACG	TTTaCCACCAAGTCTGATG	ATAGATTTACCACCAAGTCTGATGTGGTGA	MST1R_p.T1265A
TTTGCAGTAGTCTCAGTATCGAC	CGCaTGGAGCGGGAACGGC	GGGAGCGCATGGAGCGGGAACGGCTGGAGC	SAFB_p.M664V
TTTGATGATCGTCATCTCGTCAC	AACaAGGAAGGGGAGGTGA	TGATCAACAAGGAAGGGGAGGTGATGGATG	IKZF3_p.K444E
TTTGGATCAGTATATCATCACGT	AGGGGaCATAGGGCCCCCA	CCAAAAGGGGACATAGGGCCCCCAGGGCCA	SCARA3_p.D542G
TTTGTAGCACTATCTACTATATA	TAGaAGAATTTGACAAAGA	TATGATAGAAGAATTTGACAAAGATGGTGA	CETN3_p.E144G
TTTGCTGTCAGATCATCTAGTCA	TGGGAaTGAGGAGAAGGAA	AGGGATGGGAATGAGGAGAAGGAAAGGCTG	ZNF785_p.N117S
TTTGTATCGCATCACTACATCAT	TGGGAaTGAGGAGAAGGAA	AGGGATGGGAATGAGGAGAAGGAAAGGCTG	ZNF785_p.N117S
TTTGATGTATCTATCTAGTACAG	TCTTCaTGAGACTGGGATG	GCAGTTCTTCATGAGACTGGGATGTGGTAA	RELN_p.M2230V
TTTGTACACTAGCATCTATCGCT	GATGaCGGAGCCCAGGAGG	GGACTGATGACGGAGCCCAGGAGGTGGTGA	ARFGEF2_p.D283G
TTTGCGTCATCATCACTGTATAT	GATGaCGGAGCCCAGGAGG	GGACTGATGACGGAGCCCAGGAGGTGGTGA	ARFGEF2_p.D283G
TTTGTACTCATCACAGCATCGTC	AAGAaCTGTGTGTGGCAAG	CTAATAAGAACTGTGTGTGGCAAGTGGTTG	TLL1_p.N643S
TTTGATATCATCTAGCAGTCTAG	GAGGaGAGGCTACATGAGC	AACAGGAGGAGAGGCTACATGAGCAGGAGG	GOLGA6L10_p.E213G
TTTGCAGATCGTCTATAGTCAGT	CCCaGCTGGCCTTTGGCTG	GGACACCCAGCTGGCCTTTGGCTGTGGGGT	TMEM104_p.Q450R
TTTGCTATCACAGCATGTCAGAG	CGCTaCCTGCCTGTCCGGA	TGACACGCTACCTGCCTGTCCGGAAGGAAG	PHLDB2_p.Y1069C
TTTGACATCGAGTCAGCATCGCA	CCTCaAGCGGGTGATTGTG	CTGCCCCTCAAGCGGGTGATTGTGCGGAAG	USP38_p.K18E
TTTGCATCAGAGCAGTAGTCAGA	CCAGaGGACCTGGAGAGCA	GTGTCCCAGAGGACCTGGAGAGCAGGGAGG	RP13-395E19.1_p.E424G
TTTGTGTGTGTGTGTATCTATAT	GATGaAAAACTGAAGAAGC	CTTAGGATGAAAAACTGAAGAAGCTGGTGG	MYB_p.E49G
TTTGCTGTATCATCTATCTCTCG	GATGaAAAACTGAAGAAGC	CTTAGGATGAAAAACTGAAGAAGCTGGTGG	MYB_p.E49G
TTTGCAGAGTCATATATCGACGC	ACATaTCTAAAGAAAGGTA	TAAAAACATATCTAAAGAAAGGTAAGGTTC	FMN1_p.I1150M
TTTGGTGTCTGTCAGCATCTACT	GGGaGAAGATATCCTCCTC	GGTGTGGGAGAAGATATCCTCCTCAGGAAC	ZSCAN21_p.E146G
TTTGTCGCAGTAGTCATACGTCA	AAAGaCGTCTGCTTGGACC	AGGCAAAAGACGTCTGCTTGGACCAGGGGC	WBSCR17_p.D476G
TTTGCACTCACTATCTATCGCGT	GAATGaGGAGGACGACATG	CCAAAGAATGAGGAGGACGACATGCGGGAG	NUCB1_p.E282G
TTTGACTATCATCATCATCAGCA	TGCaGAGACCAAAAGGTCA	TCCCCTGCAGAGACCAAAAGGTCAAGGAAA	YTHDF2_p.001
TTTGCTCATGTGTCATCATATAG	TACaTCAAAGGATTCATAC	TACTGTACATCAAAGGATTCATACCGGAGA	ZFP28_p.H551R
TTTGAGTCATCATGTCATACATC	GAGaCAGCGAGTCGATACC	TTTAAGAGACAGCGAGTCGATACCAGGAGT	SH2D1B_p.D32G
TTTGCTAGTCTATGTATCGTATA	CCCaGTTCAAGTGCAACAG	TAGCACCCAGTTCAAGTGCAACAGCGGGCG	LRP1_p.Q1019R
TTTGTATCAGTCTCGTCTATCGT	AAATGaAATGTAAGATTGC	AGAAAAAATGAAATGTAAGATTGCAGGTTG	EFCAB1_p.K106E
TTTGTGTCATCGCATCATATCAG	TTGATaGTAGCCCAGCATG	ATTCCTTGATAGTAGCCCAGCATGTGGAAA	GOLGA4_p.I1811M
TTTGAGTAGTATATCAGCACTCG	GGGCaGGTTACCGTTACCA	TTCCAGGGCAGGTTACCGTTACCATGGAGA	SAP130_p.Q171R
TTTGGAGCATATCTATCATCTCA	GCTaTGAAGCGGATTGTTG	TGGATGCTATGAAGCGGATTGTTGGGGTAG	AP3B1_p.M63V
TTTGCATCTGTCAGTATATCTAT	AAAaGCAGAAAAGAAAGAC	GTCCCAAAAGCAGAAAAGAAAGACTGGCAC	LRFN5_p.K642R
TTTGATATGTCACTACAGTCTAG	AAAaGCAGAAAAGAAAGAC	GTCCCAAAAGCAGAAAAGAAAGACTGGCAC	LRFN5_p.K642R
TTTGACTATCATCTCAGCGTATC	CGGCaGTTGGCTGAGATGC	AGGTGCGGCAGTTGGCTGAGATGCAGGCTA	CCDC41_p.Q255R
TTTGTCATAGTCATGTCATATAT	TCTaCTTAAAACCACTAAG	GGCACTCTACTTAAAACCACTAAGTGGAGG	RC3H2_p.Y108C
TTTGATCATCATCATGTAGTCTC	CTTACaGAGTGAAAAATCA	GAAGCCTTACAGAGTGAAAAATCACGGTAG	GOLGA5_p.Q326R
TTTGTCATAGTATCAGTATCGAC	CTTACaGAGTGAAAAATCA	GAAGCCTTACAGAGTGAAAAATCACGGTAG	GOLGA5_p.Q326R
TTTGCGCATCTAGTCATCTAGCT	CTTACaGAGTGAAAAATCA	GAAGCCTTACAGAGTGAAAAATCACGGTAG	GOLGA5_p.Q326R
TTTGAGTCAGTCACTACAGTCTA	CTTACaGAGTGAAAAATCA	GAAGCCTTACAGAGTGAAAAATCACGGTAG	GOLGA5_p.Q326R
TTTGCGCATGTCAGAGTAGCATC	TGATCaTGATGTTCACGGA	CAAGATGATCATGATGTTCACGGATGGTGG	CACNA2D2_p.M397V
TTTGATGTCAGTATCATCTAGAT	ATaGAGAAAGAAACTGCAA	AGGATATAGAGAAAGAAACTGCAAAGGATG	ADAM9_p.I182M
TTTGCGTCACTAGTATATATCGC	GTGTGaGTGGCCCCGACCC	CAGATGTGTGAGTGGCCCCGACCCAGGGGA	HNF4A_p.E397G
TTTGGTAGTCAGAGTAGCATCTA	GTGTGaGTGGCCCCGACCC	CAGATGTGTGAGTGGCCCCGACCCAGGGGA	HNF4A_p.E397G
TTTGCTCTAGTACTATCATCACG	TAGaACCTGCTCCCCACGC	AGAGCTAGAACCTGCTCCCCACGCAGGGCT	AMBN_p.E346G
TTTGCGTATCGCATCATCACTAT	GTGGGaCCTGAGAACCCTG	AGACTGTGGGACCTGAGAACCCTGAGGTAA	WDR27_p.D769G
TTTGTATCATCTCATAGTCAGTC	ATCCaGGAACTTCCATGTG	TGTCCATCCAGGAACTTCCATGTGTGGAAC	TGM1_p.001
TTTGCGTGTCATCATGTACGTCA	TGaCTGTAAAGTAGAAGGT	GCTTTTGACTGTAAAGTAGAAGGTAGGTTT	PREX2_p.D785G
TTTGCGCATCATCACGACTATAC	ACaGTGGGGTGGACCTGAG	GTCTGACAGTGGGGTGGACCTGAGTGGGGA	PRRC2A_p.S1651G
TTTGATAGTCGCTCATATATCGT	CGCTaTGGCTGCGCTGCGA	GCCTCCGCTATGGCTGCGCTGCGAAGGCTC	EFHA2_p.M1V
TTTGTGCATCATAGCATCATGTC	CAAGTaCAAGAAGAAAGAA	AAAACCAAGTACAAGAAGAAAGAAAGGAAT	OSBPL8_p.T819A
TTTGACGTGTCATATATCATATA	TTTaCAAGTGTAATGAATG	GAAACTTTACAAGTGTAATGAATGTGGCAA	ZNF845_p.Y523C
TTTGACATCATACGCTCATCTAC	ATTaCAATCAGATGGCTAC	AGTCCATTACAATCAGATGGCTACAGGTAA	EGR3_p.Y46C
TTTGCATCTCATCACAGCAGTAT	GACaGCAGGGAGGTGAAGG	CCACAGACAGCAGGGAGGTGAAGGTGGGAG	GABBR2_p.S434G
TTTGCATATATCACATACTCATA	GAAAaGGCGGCAGACAGGC	AGGAGGAAAAGGCGGCAGACAGGCTGGAGC	CCDC137_p.K182R
TTTGTCAGATCAGAGAGTATATA	GAAAaGGCGGCAGACAGGC	AGGAGGAAAAGGCGGCAGACAGGCTGGAGC	CCDC137_p.K182R
TTTGCACTCACAGAGCAGTAGTA	GCTACaAATGTGAAGAATG	GAAACGCTACAAATGTGAAGAATGTGGCAA	ZNF676_p.K506E
TTTGTCTCACGAGTCATCATCAT	TCTaTGAGGAGGAGAACCC	CATTTTCTATGAGGAGGAGAACCCAGGGGG	ZER1_p.Y144C
TTTGCAGAGCATCTAGTCATCTA	TCAGAaCCGGCCAGTTCAG	ACTGCTCAGAACCGGCCAGTTCAGAGGTTT	PKNOX1_p.N339S
TTTGCGTATCACATATCTATCGA	TTCCaTGAGCGGAAGGAGA	AGGCCTTCCATGAGCGGAAGGAGAAGGCCC	SAFB2_p.H655R
TTTGATAGCATCACTATCTACGC	ACCaTAGTGCACATTGACA	GCAATACCATAGTGCACATTGACATGGATG	POLK_p.I103V
TTTGATCAGATCATCTATAGAGA	ACCaTAGTGCACATTGACA	GCAATACCATAGTGCACATTGACATGGATG	POLK_p.I103V
TTTGAGATCATCTATCATCGCAG	ATaTGGTGCACCTGAAGAT	ACAGAATATGGTGCACCTGAAGATTGGGAA	TBCE_p.Y425C
TTTGCACAGTAGTAGTATAGTAG	ACCCCaCCCACCACGAGAG	GAAGCACCCCACCCACCACGAGAGGGGCCA	MLLT6_p.T232A
TTTGATACATCTCATCGACATCA	GCTaTGACTCTGTATGAAC	AGTTTGCTATGACTCTGTATGAACAGGTGA	USP53_p.M157V
TTTGGTGTATCAGCATCGAGATC	CTGGaCGAGCAGAACCGCG	TCCGGCTGGACGAGCAGAACCGCGTGGACC	CCDC166_p.D95G
TTTGGTGTCATCATATATCGTAT	GCCaGCTCCGAGCCCAGGG	GCTGGGCCAGCTCCGAGCCCAGGGTGGCAG	GOLGA3_p.Q1026R
TTTGCGCATCTAGTCAGAGCATC	CACGGaGGGGGCCCGCCTG	CTCCGCACGGAGGGGGCCCGCCTGCGGGTG	FES_p.E651G
TTTGGAGTCAGTATCAGTAGCTA	CCCTaTGGCTCTGATCGGC	CCAGCCCCTATGGCTCTGATCGGCTGGTAC	ZBTB32_p.Y12C
TTTGATCATGATCAGTAGTCTAT	GAGCTaACCTGGTATCATG	AGGAGGAGCTAACCTGGTATCATGTGGAGG	WDR49_p.N391D
TTTGGATCTATCATACATACGCT	TAATaGAAAGCTATAAAAA	GCAGCTAATAGAAAGCTATAAAAATGGAGG	DGKI_p.I943M
TTTGACTCTAGCATCTATCTATA	ATAAGaTGAACTCAGTTGA	CATCCATAAGATGAACTCAGTTGAGGGTCG	OR2T10_p.M228V
TTTGTGTATATCATCTGTCGCTC	ATAAGaTGAACTCAGTTGA	CATCCATAAGATGAACTCAGTTGAGGGTCG	OR2T10_p.M228V
TTTGCTATCATCTCACTACAGAT	TTAaGTGGAGTAAATGGGC	CTGGATTAAGTGGAGTAAATGGGCTGGCAG	SDR16C5_p.S182G
TTTGCTATGTGTGTCATCGTCAT	CCACaTCTTCAAGTCTGGT	CTGATCCACATCTTCAAGTCTGGTAGGTGA	HTT_p.I1786V
TTTGTCACTCATCGTCTAGTAGC	CTGaCCCGGCTATATGTCC	ATGTGCTGACCCGGCTATATGTCCTGGAGG	NBEAL2_p.T1289A
TTTGGTATATCATGTCTAGTATA	CTGaCCCGGCTATATGTCC	ATGTGCTGACCCGGCTATATGTCCTGGAGG	NBEAL2_p.T1289A
TTTGTAGAGAGCATATCTATCAG	AGAGGaTTTGTGGGGCGAG	AAAGAAGAGGATTTGTGGGGCGAGTGGAGC	IL27RA_p.D215G
TTTGTCATCTACTATCTATCTAC	AGAGGaTTTGTGGGGCGAG	AAAGAAGAGGATTTGTGGGGCGAGTGGAGC	IL27RA_p.D215G
TTTGTATGTGTCGCAGTATCTAC	CAGCaGAAAACTGCTTAGA	AGGGACAGCAGAAAACTGCTTAGAGGGATG	H2AFV_p.Q125R
TTTGTATATCACTAGTATCGTCT	GTCaCCTGGGAGGCTGAAG	ATGGTGTCACCTGGGAGGCTGAAGTGGAGC	GTF3C1_p.T866A
TTTGCGTATCGTCACTATATCGC	CCCaCTGTGGCCCCGGCAC	CGGGGCCCACTGTGGCCCCGGCACAGGTGG	KRT79_p.H49R
TTTGACATCATCATACTCATCGC	CCAGGaGTACCCGGAAGGA	AAGACCCAGGAGTACCCGGAAGGACGGGAT	ACACB_p.E1781G
TTTGGTACATCGCTCATCATACG	GAAGaTCAGAAGCCAGTCA	GTCGGGAAGATCAGAAGCCAGTCATGGATG	CD74_p.D12G
TTTGGACATCTATCAGTCACTAG	CTAaGAAAACCTCCCAGAT	AGCCTCTAAGAAAACCTCCCAGATAGGGGA	INA_p.K461R
TTTGGTATCTCAGTATATCTACG	GGaGTGGAAATCAGAAGGT	GAGGGGGAGTGGAAATCAGAAGGTTGGAGC	SLC47A1_p.S402G
TTTGTCTATCACTAGCAGTATCG	GGaGTGGAAATCAGAAGGT	GAGGGGGAGTGGAAATCAGAAGGTTGGAGC	SLC47A1_p.S402G
TTTGTAGTGTGTCATCGTATAGC	AAGCaTGAAGAAATTGATC	GGTCAAAGCATGAAGAAATTGATCTGGTCA	THOC5_p.H154R
TTTGCGTACAGTATCATCATCGC	TTCTaTGAGAATCAACATG	CCTATTTCTATGAGAATCAACATGAGGTGG	AKR1B15_p.Y49C
TTTGCAGATCATCATCGACTAGA	GAAGaAGAGCTTCTTTCAG	GATATGAAGAAGAGCTTCTTTCAGAGGTGG	GLB1L2_p.K527E
TTTGCTCTATCGAGTAGCATCTA	AAGaGGAAGCGGAAACCAG	ACATCAAGAGGAAGCGGAAACCAGTGGCCA	C14ORF118_p.R409G
TTTGAGTGTCTACATCTCAGTAC	AAGaGGAAGCGGAAACCAG	ACATCAAGAGGAAGCGGAAACCAGTGGCCA	C14ORF118_p.R409G
TTTGCTCAGAGAGTAGCATATAT	CCGAaGAAGGGTTCCAAGA	CTGCTCCGAAGAAGGGTTCCAAGAAGGCTG	HIST1H2BG_p.K12R
TTTGACGTCTATCACTAGCTATC	CCGAaGAAGGGTTCCAAGA	CTGCTCCGAAGAAGGGTTCCAAGAAGGCTG	HIST1H2BG_p.K12R
TTTGGTATCTATGTATATATCGA	TCCaACTCTGAGGATGAGG	CTGACTCCAACTCTGAGGATGAGGAGGAAG	NOP2_p.N145D
TTTGTGTACAGTATCATCTCAGT	GATaAAGAAAACAAATCTT	CTCATGATAAAGAAAACAAATCTTCGGAGC	PREX2_p.K972E
TTTGCACACAGAGTCATCATCTC	GATaAAGAAAACAAATCTT	CTCATGATAAAGAAAACAAATCTTCGGAGC	PREX2_p.K972E
TTTGCATCTCACTACATCATACA	GATaAAGAAAACAAATCTT	CTCATGATAAAGAAAACAAATCTTCGGAGC	PREX2_p.K972E
TTTGACAGATCATATCATCATCG	GATaAAGAAAACAAATCTT	CTCATGATAAAGAAAACAAATCTTCGGAGC	PREX2_p.K972E
TTTGTATATGTATCATCAGCTAG	GAGCaGGTCCTCAGCCTAG	CCTCTGAGCAGGTCCTCAGCCTAGTGGCCC	MLYCD_p.Q479R
TTTGATGTGTGTATAGTATCAGC	ATGaTGCTCACCCACCTGG	GCAAGATGATGCTCACCCACCTGGTGGTGC	CHD5_p.M1167V
TTTGAGAGAGCATCACTAGCATA	AATGaGGGGCTGAATGTTC	TAGAAAATGAGGGGCTGAATGTTCTGGTTT	NIN_p.E1319G
TTTGGTATATCACTATCTAGTAG	GTGGCaTGTTCCCTTTGAG	GACAGGTGGCATGTTCCCTTTGAGGGGACA	AHCTF1_p.M339V
TTTGCTCAGTATCACTAGTATCG	GGGGaGCTGAGGTCCCCAG	AGAATGGGGAGCTGAGGTCCCCAGAGGCCG	LMTK3_p.E1007G
TTTGGAGCACTATCATCTATACG	GACATaAAAATTAATGCTC	AAGATGACATAAAAATTAATGCTCTGGTGA	ZDBF2_p.I1841M
TTTGATCATCGTCTATATCACTA	ACaTGGTAGCTGGGGAAAG	AGTGGACATGGTAGCTGGGGAAAGAGGAAC	RNF10_p.H162R
TTTGACTCAGTATATCTCACTAT	TGGaAAAGATCAAGACGAT	GCAGCTGGAAAAGATCAAGACGATTGGTAG	ADCY6_p.E1028G
TTTGGTATAGCATCATCATCGTC	ATATaTAATGGAGAGACTC	TGGGGATATATAATGGAGAGACTCTGGTAT	PCYOX1_p.Y121C
TTTGAGTATCACAGTATCGAGAT	ATATaTAATGGAGAGACTC	TGGGGATATATAATGGAGAGACTCTGGTAT	PCYOX1_p.Y121C
TTTGATAGTCAGATCAGTATCAG	CATTTaCAGAGGATAGATT	AGCATCATTTACAGAGGATAGATTTGGAGT	TMEM48_p.T577A
TTTGTCTCAGAGTCTCGCGTATA	AGAGaAGCCTCGTAAAACC	AAAGAAGAGAAGCCTCGTAAAACCCGGGGC	ZNF22_p.K193E
TTTGACTGTGTAGTCATCGCAGT	AAAaGTGTAGGTGAGTGTG	GCTGTAAAAGTGTAGGTGAGTGTGAGGTGC	ZNF716_p.S131G
TTTGTGTCATCGCATCATAGCTC	TTCCaGGCAACCCTGCTCA	TCACATTCCAGGCAACCCTGCTCATGGATG	PLXDC2_p.Q246R
TTTGAGTGTACAGTATCTATCTA	CCAaaCCTGATATAATCAG	GAAAGCCAAACCTGATATAATCAGTGGAGA	C6ORF170_p.K959K
TTTGCTATCGATCAGCATACGTC	CCAaaCCTGATATAATCAG	GAAAGCCAAACCTGATATAATCAGTGGAGA	C6ORF170_p.K959K
TTTGTCGCATCACATATATCTAC	TGAGGaACCCAGACAGGTA	AGCTTTGAGGAACCCAGACAGGTATGGAGA	BTBD16_p.N53D
TTTGTGACAGTCAGTATCTACGC	CCCaTCAGAGTCAAAGGCA	AGTTGCCCATCAGAGTCAAAGGCAAGGAGG	ANK2_p.I1789V
TTTGGCATATGTCATCATCTACA	AAATaTCAAGCTAATAGGA	CGAGAAAATATCAAGCTAATAGGAGGGAAA	USP34_p.I3099V
TTTGATCAGTGTATCATCATCTG	GCCaGGGGCTTAATAGCCC	TTGTGGCCAGGGGCTTAATAGCCCGGGGAG	DCXR_p.R120G
TTTGTACAGCATCATCATCACGC	ACTaGAATACTGGAAAAAG	AGATCACTAGAATACTGGAAAAAGAGGTGT	SCAPER_p.R695G
TTTGGTGTCATCTCATAGCATAT	CCGGaTGTGGTGCTGAAGC	ATGACCCGGATGTGGTGCTGAAGCAGGTAG	TTLL12_p.D520G
TTTGATGTATCAGTATAGCATAT	GCTCaAGCTGTCCCAGGCC	AGGAGGCTCAAGCTGTCCCAGGCCCGGGTG	SH3TC1_p.K575E
TTTGGAGCATCATCTAGATCATA	GCTCaAGCTGTCCCAGGCC	AGGAGGCTCAAGCTGTCCCAGGCCCGGGTG	SH3TC1_p.K575E
TTTGTCATCAGTCAGTCTCACGT	GTCaGGTGGGCTGGAATCG	CTTATGTCAGGTGGGCTGGAATCGAGGGGA	PRPF8_p.Q1595R
TTTGCGTCAGAGCATCTATCGCA	TTGCaAAACTCATGGGAGA	AAAAATTGCAAAACTCATGGGAGAGGGTTA	CBLB_p.A915A
TTTGTCGCATCGTCATCTCACTA	TCCaTGGAAGGCATGGGGA	TAAAGTCCATGGAAGGCATGGGGAAGGTGA	DYRK2_p.M143V
TTTGGTACAGTATATCATCTCTA	TCCaTGGAAGGCATGGGGA	TAAAGTCCATGGAAGGCATGGGGAAGGTGA	DYRK2_p.M143V
TTTGGCATAGCATCATCTGTATA	ACTaTGACCCAGAAGAACA	TGGTGACTATGACCCAGAAGAACATGGCAG	EPB41L2_p.Y348C
TTTGCTCTAGTATCATATATCAG	GTGaTGGGCCCCTCAGCCA	ACATCGTGATGGGCCCCTCAGCCAGGGCTG	PCNXL2_p.M2068V
TTTGCTCTATCATCTACATACGC	AGGaGGAGGCAGAGTGGGT	CCCAGAGGAGGAGGCAGAGTGGGTGGGCCT	MRPL28_p.E199G
TTTGCGATCTATCATCATCATCA	AGGaGGAGGCAGAGTGGGT	CCCAGAGGAGGAGGCAGAGTGGGTGGGCCT	MRPL28_p.E199G
TTTGTGTCAGTGTAGCTATCATC	CTGaTGGGTGAGGAGGACG	ACTGGCTGATGGGTGAGGAGGACGAGGACA	SIN3B_p.M1124V
TTTGATCGCTCATAGCATCATCA	CTGaTGGGTGAGGAGGACG	ACTGGCTGATGGGTGAGGAGGACGAGGACA	SIN3B_p.M1124V
TTTGCAGAGTGTCTATATCATAT	GGAAaGAAGGGGGAGTTCC	GCTTTGGAAAGAAGGGGGAGTTCCAGGAGG	TBL2_p.K262R
TTTGTGCATCATCTACATCTGTA	CAGAAaTGTGCGCAGTGCC	AGAATCAGAAATGTGCGCAGTGCCTGGTGG	XIRP2_p.M248V
TTTGTCATGTCATCATACATACA	AGTGTaTACTCATGATATG	GAGACAGTGTATACTCATGATATGAGGAAG	TAF2_p.Y225C
TTTGTATCAGTACGTATCAGCAC	GAGGGaAAACAGGACCTCC	AAGACGAGGGAAAACAGGACCTCCCGGAAA	COL19A1_p.K413E
TTTGCTCATCTCAGTATCTATGT	AGGCaCGGTGGGCTTTCCT	CTTTGAGGCACGGTGGGCTTTCCTTGGTTC	SEPHS1_p.H77R
TTTGATCGTGTCATCGTCAGCAC	GGCaCGGCGATCTGTGATT	GGCGGGGCACGGCGATCTGTGATTGGGTCT	ACSL6_p.A70A
TTTGGAGTGTGTATATCTACTAC	GTGTaGTGTGGCTGTGTGC	TCTGTGTGTAGTGTGGCTGTGTGCAGGTTT	SF3B3_p.001
TTTGTGAGTCATCATACGCATCG	GATGaTCATAAGAACCCGA	ATGAAGATGATCATAAGAACCCGACGGTGA	PAPPA_p.D364G
TTTGTCGACATCATCATCGTGTA	GATGaTCATAAGAACCCGA	ATGAAGATGATCATAAGAACCCGACGGTGA	PAPPA_p.D364G
TTTGAGTATATCAGCACTAGATC	AAGGTaAAAGGAAAGGACC	CAAGAAAGGTAAAAGGAAAGGACCAGGAGG	EPS8_p.K307E
TTTGTCTCATGATCTATCATCGC	GAGGaCCAGGAGATCCAAA	CAAGGGAGGACCAGGAGATCCAAAGGGAAG	USP17L2_p.T512A
TTTGACTCAGTAGCGTATCTATC	AAGGTaTTGGTGGCATGGA	TTATAAAGGTATTGGTGGCATGGATGGAAC	FASTKD1_p.I693V
TTTGACTGTATCTATAGCATCTA	AGTCCaTATCAGTTGCAGC	TGACAAGTCCATATCAGTTGCAGCTGGAGA	SIRPB1_p.I42V
TTTGCTGTCTCATCTCACATATA	ACTGaTGGGGATGAGATGC	ATTGGACTGATGGGGATGAGATGCAGGTTG	PAN2_p.D826G
TTTGGATATCTATCATACGACGC	GGAGTaCTCGTGTGTGTGC	GCCGGGGAGTACTCGTGTGTGTGCGGGCAG	OBSCN_p.Y3782C
TTTGACTCATCACAGTAGTCATA	CCGGaTGGGGCAGTGCCAG	GTGATCCGGATGGGGCAGTGCCAGGGGCTC	LAMB3_p.D384G
TTTGTCTACAGTATCTGTATCGT	CTCCTaCTTGGGAAAGCCC	GGATCCTCCTACTTGGGAAAGCCCAGGAGA	SETD2_p.T1918A
TTTGACGCATCATCACTACATAT	GAATGaGACCCCTGGGGAA	GGAGGGAATGAGACCCCTGGGGAAGGGACT	C8ORF86_p.R2G
TTTGCTAGTCAGAGTCATCGCTA	GGTaCCTGGACTACCTGGA	TGGGGGGTACCTGGACTACCTGGAAGGCAT	SLC24A6_p.Y80C
TTTGTATCATCTCACGTCTATCT	GGTaCCTGGACTACCTGGA	TGGGGGGTACCTGGACTACCTGGAAGGCAT	SLC24A6_p.Y80C
TTTGCAGTGTAGTCAGCATCTAT	AAGaTCCGCAAAATCGGGG	CTGAGAAGATCCGCAAAATCGGGGAGGCGG	FLOT2_p.I319V
TTTGTGAGACATCTATCATATAT	TTAAaCTCGCTCCCCAGGT	AGGAATTAAACTCGCTCCCCAGGTAGGTAA	A1CF_p.K437K
TTTGCAGAGCATCACTAGTATCT	GGGaCGGCTCTCCAGACAT	AGCAGGGGACGGCTCTCCAGACATAGGCCC	FGD3_p.D54G
TTTGATCGTCTATCGCTCATGTC	AATGTaCTGTTGATATTGG	TGATAAATGTACTGTTGATATTGGGGGATT	ZNF507_p.T448A
TTTGACAGATCTATCATCTCAGC	CCTATaTATGTACTGTGTG	AAGACCCTATATATGTACTGTGTGTGGTAA	ZNF484_p.I497V
TTTGTAGTCATCGTCATCTCAGT	TAGaAGATGCCTCTAATGG	AACCCTAGAAGATGCCTCTAATGGAGGAGT	TPCN1_p.E31G
TTTGTCTACATGTCAGTCAGTCA	ATGATaGTAATAGAGTTCA	CAGTCATGATAGTAATAGAGTTCATGGAAA	EPHA7_p.I709M
TTTGCATATATCTACAGTCTATC	CTGTaTAAACTGAAGTTAG	CCATTCTGTATAAACTGAAGTTAGGGGAGA	ARF4_p.Y35C
TTTGGCAGTCTATCATGTCATAC	GGGGaCCGGCGGGAACGGA	GTGTGGGGGACCGGCGGGAACGGAAGGCTG	CTSG_p.D189G
TTTGACATCTAGTAGTATAGTAG	GATCaGAAACTTTCGAAGT	ATATGGATCAGAAACTTTCGAAGTTGGTAG	KIAA1530_p.Q3R
TTTGCACTGTATCATCGCATCTA	TATCaAAACTACAAGGAAA	TCCTGTATCAAAACTACAAGGAAAAGGCCC	ARHGEF26_p.Q381R
TTTGTCGTCATCGTCAGCAGTAT	TATCaAAACTACAAGGAAA	TCCTGTATCAAAACTACAAGGAAAAGGCCC	ARHGEF26_p.Q381R
TTTGCAGTACATCATCTCATATG	ACTaTGGATGCTGGGAAAC	AGGCAACTATGGATGCTGGGAAACTGGTAG	AK2_p.M68V
TTTGCTATCGTCAGTCTCTACGC	CCCaGGGGGGTGTGTTCCA	GCGGCCCCAGGGGGGTGTGTTCCAGGGAGA	OSBPL7_p.001
TTTGTACAGCATCATGTCATAGC	AAAGaCATACCAAAAAAAC	CTTGGAAAGACATACCAAAAAAACAGGATT	DAPL1_p.R14G
TTTGTGTAGTACATCATCTCAGC	GGTaAGATTTCAGAGGTAC	TTATAGGTAAGATTTCAGAGGTACTGGATG	SERPINB8_p.K143E
TTTGCAGATCATCAGCATCTAGT	CACCTaGGGATGTGAGTCT	CCAGCCACCTAGGGATGTGAGTCTTGGCTG	RP13-395E19.1_p.R55G
TTTGGTCATCTATAGTATATCAC	AGAGCaAACAGTGATTCTG	ATTTCAGAGCAAACAGTGATTCTGGGGAAA	ZNF250_p.Q142R
TTTGGCATCTATAGCATCTATGT	AGAAGaAACGTGAGAGATC	TAATCAGAAGAAACGTGAGAGATCTGGTAG	FAM134B_p.K124E
TTTGTCATACAGTAGTCTCGCAT	CTGTTaTAGTGGAAGTATC	TAAAGCTGTTATAGTGGAAGTATCAGGACA	C14ORF149_p.I324V
TTTGATCAGACAGTATCTATCAT	ATCaCCAACCTGCGGTATG	TCACCATCACCAACCTGCGGTATGAGGAGA	MUC16_p.T13644A
TTTGAGTCAGAGCATATATCGTC	AGAGaGGATGGTGGCACAT	CAGGAAGAGAGGATGGTGGCACATTGGCTA	USP8_p.E144G
TTTGTGACATCGTCTATCTACTA	GAAAGaCCTGTGGCAAAAG	TTGCTGAAAGACCTGTGGCAAAAGAGGCAG	FGB_p.D153G
TTTGCGTCAGACATCATCATCTC	GCCGaCCTGGTCTCGGAGA	ACCTGGCCGACCTGGTCTCGGAGATGGAGG	FGFR4_p.D476G
TTTGATAGTCATCACAGTATCGT	AAGaAGGAGAAAGTGAGTC	AAAACAAGAAGGAGAAAGTGAGTCCGGGCC	PPP2R5C_p.K7E
TTTGGTGTCACATAGTCTCATAC	GAGCaGGAGAATGCGGAGC	AGCTGGAGCAGGAGAATGCGGAGCTGGAGG	KRT38_p.Q127R
TTTGTCTCGTCTATCTCTACATA	GGCTaCTTCTACTTTGGTA	AGGGGGGCTACTTCTACTTTGGTAAGGAGG	TRPV4_p.Y281C
TTTGATGATCAGCATATCATCTA	CCAaGAATCCGGGTGACCG	AGACGCCAAGAATCCGGGTGACCGTGGTCT	PLXNB1_p.R1284G
TTTGAGTATCTCATGTATATCAT	CCAaGAATCCGGGTGACCG	AGACGCCAAGAATCCGGGTGACCGTGGTCT	PLXNB1_p.R1284G
TTTGACAGTATCTATCAGCACGA	GGTGCaCTGATGCAGAAAA	CTTTAGGTGCACTGATGCAGAAAAGGGCAA	GUCY1B3_p.T123A
TTTGCTAGTATATCACAGTAGAG	GGTGCaCTGATGCAGAAAA	CTTTAGGTGCACTGATGCAGAAAAGGGCAA	GUCY1B3_p.T123A
TTTGACAGTGTATCTAGTATAGC	AAaTCAAGGTCTTGATCTT	TGGCAAAATCAAGGTCTTGATCTTCGGTAG	PIK3CA_p.N826S
TTTGGATCACAGCATGTCATCGC	AAaTCAAGGTCTTGATCTT	TGGCAAAATCAAGGTCTTGATCTTCGGTAG	PIK3CA_p.N826S
TTTGTGAGAGATCATATATCTAG	AAaTCAAGGTCTTGATCTT	TGGCAAAATCAAGGTCTTGATCTTCGGTAG	PIK3CA_p.N826S
TTTGTCATACATCATCGCATCGC	AAaTCAAGGTCTTGATCTT	TGGCAAAATCAAGGTCTTGATCTTCGGTAG	PIK3CA_p.N826S
TTTGATCATAGTCATCTCGTCTA	ACTaTCAGTTCCAGAGATA	GTTTGACTATCAGTTCCAGAGATATGGGTA	SETD2_p.Y1163C
TTTGCGTCGTCATCTATCATCGA	CTAaTCGAACTATTGTAGA	ATTGGCTAATCGAACTATTGTAGAAGGGTA	CCDC132_p.N856S
TTTGCTGTGTGTCAGTACGTATC	ACACCaGAGAGTCAGACCA	CCGAAACACCAGAGAGTCAGACCAAGGTGT	PXDNL_p.R296G
TTTGTCGAGTCATCTAGTACTAC	TCTACaTCGATCCTGAGAA	CATGTTCTACATCGATCCTGAGAAAGGAGA	CDH13_p.I301V
TTTGGTCATAGTCAGCATGTCAC	AATaCCTGTACAGCCAGGA	TGTGGAATACCTGTACAGCCAGGATGGCAG	ACACA_p.Y367C
TTTGCATGTGTCAGCATCATACG	CGAaTGTGAGTTTCCCCTG	TGAAGCGAATGTGAGTTTCCCCTGTGGAGA	SLIT3_p.I336V
TTTGCAGTCATCGCATAGCATCG	AGGaCGAGTTCTCGGGCAG	CTACAAGGACGAGTTCTCGGGCAGAGGCGA	CYP2E1_p.D95G
TTTGGTCTCATATATATCTATAG	ACGaAAGCTCCAGTAGAGA	AAGGTACGAAAGCTCCAGTAGAGAAGGAGG	VCAN_p.K2070E
TTTGTCAGTCACTGTATCTATAG	AGGaGCCCGAGCAGCCGAA	GTGGCAGGAGCCCGAGCAGCCGAACGGCAT	EPHA8_p.E462G
TTTGTGTGTAGTCATCATCGCAT	TTGTaCTCAGGAAGCTGAG	TCTCATTGTACTCAGGAAGCTGAGTGGAGC	PKHD1L1_p.T2826A
TTTGATCATCATCGCTCATCACA	CAGTTaCAATTGTTGTTCG	AAAAACAGTTACAATTGTTGTTCGTGGTTC	CCT4_p.T387A
TTTGAGTGATCATCATCACGTCA	TCTaTTCGGGAGATGACCC	TGATGTCTATTCGGGAGATGACCCAGGTAT	PARP6_p.I392V
TTTGAGTGTCATATAGTCATACG	GGGGGaCCAGCCCCTCTCA	GGTGAGGGGGACCAGCCCCTCTCAGGGTAT	SH2B1_p.D519G
TTTGTGCACTATCTAGTATATCG	CAGaAAGACCATGGGTTTG	CAGAGCAGAAAGACCATGGGTTTGAGGTGG	CASP9_p.K292E
TTTGGCGTGTATCATCTCTACGT	GGGaATGTGTTTTGGCCAA	AAGAGGGGAATGTGTTTTGGCCAAAGGAAC	GPHN_p.E501G
TTTGATCGTCATCTCAGCGTATC	CAGGaACTCTTTGCGGCTG	TGTACCAGGAACTCTTTGCGGCTGTGGTCT	MYO18B_p.E918G
TTTGAGTCTATCATAGCATCTAT	GAAATaCTGAATAAAAAAG	GAATTGAAATACTGAATAAAAAAGGGGAAG	AP001011.2_p.I170M
TTTGCTATGTGTATCATCTCGTC	GAAATaCTGAATAAAAAAG	GAATTGAAATACTGAATAAAAAAGGGGAAG	AP001011.2_p.I170M
TTTGATCATCATGTATAGTATAT	ACTaCAGGCTCCCAGTTCT	GCAGTACTACAGGCTCCCAGTTCTTGGAGC	UBAP2L_p.T358A
TTTGTATCATACTCATCTAGCTA	GTTCTaTTTTGAAGAACTG	GATAAGTTCTATTTTGAAGAACTGGGGAAG	GALNT2_p.Y317C
TTTGAGTCGCATCGTCATACATA	GTTCTaTTTTGAAGAACTG	GATAAGTTCTATTTTGAAGAACTGGGGAAG	GALNT2_p.Y317C
TTTGTCTCATCACAGTATCTCAG	GGGGGaGAAGCAGGAGCTG	ACGGAGGGGGAGAAGCAGGAGCTGTGGAAA	MKS1_p.E256G
TTTGCTGCAGTAGTATATATCAC	ACGTaTGAAGTAAGAGTGA	TGGAAACGTATGAAGTAAGAGTGATGGCTT	ADCK2_p.Y402C
TTTGACTAGTCTCATCATACGTA	CTTaATATCTTTAGCAACT	TGAAACTTAATATCTTTAGCAACTGGGGAC	SUN3_p.N319D
TTTGGCAGTATCTACATATAGTA	CAGGGaGGCCCTCCAGCTT	GGGGACAGGGAGGCCCTCCAGCTTTGGTCT	FN3KRP_p.E188G
TTTGCACAGCATCATCTATCTCT	TATaATCTAGAGAAGCCTG	GATTCTATAATCTAGAGAAGCCTGGGGAGT	DNAH5_p.N2687D
TTTGATCTATCATGTCGCATCGT	GATaTCAATGCCCAAATGG	TCCATGATATCAATGCCCAAATGGTGGAAG	AP2B1_p.I151V
TTTGCGTGTCAGTATCATCGCTC	GTGGaGATGATCCATTTCA	TGATAGTGGAGATGATCCATTTCAAGGACT	STC2_p.E158G
TTTGTCGTATAGTATCATCTATA	AAGCaGATTAAGCACATGA	TGAAAAAGCAGATTAAGCACATGATGGCTT	ATP6V1E2_p.Q11R
TTTGCACGTCTATCTACTCTAGT	ATTaATGTGGCAGTGGTGT	CAGGAATTAATGTGGCAGTGGTGTTGGGGG	CCT8L2_p.N291D
TTTGGTAGCAGTCAGTCTAGTAT	GTGGaCTTCTTCCTGCTGG	ACCCAGTGGACTTCTTCCTGCTGGTGGTGG	DOLK_p.D224G
TTTGGAGTCGCATCATATATCGC	CAGaCTGTATGTTTGGGAA	CTGTACAGACTGTATGTTTGGGAATGGGAA	PLG_p.D480G
TTTGAGAGCATCGCAGTATAGTA	GGTTaTGAAGGACAGAATC	TCCTAGGTTATGAAGGACAGAATCTGGCAA	DGKA_p.Y477C
TTTGCATGAGTCATCATCATAGC	TTGTaTGCTGTAGGAGGAA	GAACTTTGTATGCTGTAGGAGGAATGGATA	KLHL1_p.Y462C
TTTGTGCATCTATGTATCACTAG	CTCCaAACAAACTAGCTTA	AAGCTCTCCAAACAAACTAGCTTACGGTGA	TRAK1_p.K890E
TTTGTCAGTATCAGTCACTATGT	GTGaCCATAGAATTCGCTC	GGGATGTGACCATAGAATTCGCTCTGGAGG	ZNF99_p.T31A
TTTGTATCAGCAGTCAGTAGTCG	GAAaGAATCAAGGGCTACC	AAATGGAAAGAATCAAGGGCTACCAGGTTT	WDFY3_p.R1450G
TTTGGTCTATCATATATCATGTC	GAGCaCAGAAAGGCCCTGG	AAGAGGAGCACAGAAAGGCCCTGGAGGAGG	GOLIM4_p.H339R
TTTGTCTGTCATATATCGTCATA	TGGCCaGGTGAGGAGGGTG	GCTGCTGGCCAGGTGAGGAGGGTGAGGAGG	C8ORF73_p.S348G
TTTGACTCGTCATCACTATCGCG	TGGCCaGGTGAGGAGGGTG	GCTGCTGGCCAGGTGAGGAGGGTGAGGAGG	C8ORF73_p.S348G
TTTGCTCACTATCATCTATACGC	AAGGTaCAGATAAAGAAGG	AATTCAAGGTACAGATAAAGAAGGTGGAGC	NHLRC2_p.T322A
TTTGCTCATCACAGAGATCATCT	CCTaTGAATGTACTGAATG	GAAGCCCTATGAATGTACTGAATGTGGAAA	ZNF16_p.Y545C
TTTGTGTCAGTCTATAGTAGTAT	ACAaGGGGAAAACGGCAGA	TTGGCACAAGGGGAAAACGGCAGAAGGGAG	CEACAM4_p.K69R
TTTGGTCAGTCTCTATCGCAGTC	GAGGaTGACCAGGAGGAAG	ACCAGGAGGATGACCAGGAGGAAGAGGAGG	SYNDIG1L_p.D133G
TTTGGCAGTATCTATCGTCAGAG	GGGGaCGGAGAAGAGGAGG	ACCAGGGGGACGGAGAAGAGGAGGAGGAAG	FERD3L_p.D73G
TTTGTCTCAGTATAGCATCTACT	GGaTTGGAGTCCCCACCAA	CAACTGGATTGGAGTCCCCACCAAAGGTAA	PFKFB2_p.I65V
TTTGAGCATCATATATCTCACTA	GAAAGaAGTTAAAAAGAAG	CCCAAGAAAGAAGTTAAAAAGAAGAGGTAT	RPL5_p.E260G
TTTGTCACATCATCTCGTATCAC	GAAAGaAGTTAAAAAGAAG	CCCAAGAAAGAAGTTAAAAAGAAGAGGTAT	RPL5_p.E260G
TTTGTACGTGTATCTATCTATAG	GAAAGaAGTTAAAAAGAAG	CCCAAGAAAGAAGTTAAAAAGAAGAGGTAT	RPL5_p.E260G
TTTGTCACTCAGAGCAGTCTAGT	GAAAGaAGTTAAAAAGAAG	CCCAAGAAAGAAGTTAAAAAGAAGAGGTAT	RPL5_p.E260G
TTTGCATGTACATCATCGCGTAG	GGGGaGCCACCCCCACCAC	AGGCTGGGGAGCCACCCCCACCACTGGCGG	ZNF48_p.E440G
TTTGATCATCTATCATCTCATAC	GGAGaCTGATATACACTTA	GGATTGGAGACTGATATACACTTAAGGTAA	GDPD4_p.T231A
TTTGATCTCAGATCAGTACATCG	AACTaTATTGCGGACATTG	TTGAGAACTATATTGCGGACATTGAGGTGG	RHOC_p.Y42C
TTTGAGTAGTCATGTATCGCATA	CTTaTGAATGCAGCAACTG	AAAGCCTTATGAATGCAGCAACTGTGGGAA	FLJ16360_p.Y581C
TTTGGTGTATCAGAGTCATATAG	AATaTCATGGACCTGTATG	AAAAAAATATCATGGACCTGTATGTGGAGA	IL1F8_p.I91V
TTTGCACACAGTACGTCTATCAT	GGCaCTAGATTGTAAGAAG	GGAGAGGCACTAGATTGTAAGAAGAGGCCG	ZNF521_p.A28A
TTTGCTGTATATATCGTCTAGCG	GTGaAGGACGAGGAGATGG	AGAAAGTGAAGGACGAGGAGATGGAGGTCA	FAM50B_p.K181E
TTTGGATATCATATATAGCATAC	GTGaAGGACGAGGAGATGG	AGAAAGTGAAGGACGAGGAGATGGAGGTCA	FAM50B_p.K181E
TTTGCTCAGTGTACAGCATATCA	ATGGGaTGGAGGGGAAAGT	TTGTCATGGGATGGAGGGGAAAGTAGGAGT	FAM91A1_p.D334G
TTTGTGACATCTAGTATCATCGC	GTaCTCCGCCCCTCTGAGA	TATGTGTACTCCGCCCCTCTGAGAAGGCAG	NAV2_p.Y777C
TTTGTAGAGAGTCATCTACTACG	GAAGaCGGGGGAGCTGGAG	GAGGTGAAGACGGGGGAGCTGGAGTGGCTC	CALML6_p.T55A
TTTGTACATCATCGTGTACATCA	GCTaCTGCATGGAGGAGGA	CATCCGCTACTGCATGGAGGAGGAGGGCTG	PLEKHG5_p.Y507C
TTTGACTATCATCGTCATACATA	ATGGaGAAAAGCTCTACAC	TAAACATGGAGAAAAGCTCTACACTGGACT	CUL3_p.G70G
TTTGCTCATGTATAGTAGTATAT	AAAATaTCAAACTATATCC	TGTCAAAAATATCAAACTATATCCAGGCAC	KIAA1370_p.I298V
TTTGTATATATCATCTATCGACA	ATAGaTAATACAAACCTAC	TAATTATAGATAATACAAACCTACAGGCAT	N4BP2_p.D514G
TTTGGACATCATCTATCAGCTCT	ATAGaTAATACAAACCTAC	TAATTATAGATAATACAAACCTACAGGCAT	N4BP2_p.D514G
TTTGCTATATCATAGTCATGTCT	GGAGGaAGAAGAGGAGGAT	GAGGAGGAGGAAGAAGAGGAGGATGGGAGC	CSRNP3_p.E344G
TTTGTCACAGTAGTCTATCGCAT	AGTGGaCACAAGAAAATTT	AGAAAAGTGGACACAAGAAAATTTCGGTCT	SORBS2_p.D105G
TTTGACGTCAGCAGTATCGTCAT	TCATTaTAAAGGGAGCAGG	CCTGATCATTATAAAGGGAGCAGGAGGAAA	HIBCH_p.I86V
TTTGTCAGCATCTACATCATACG	TCATTaTAAAGGGAGCAGG	CCTGATCATTATAAAGGGAGCAGGAGGAAA	HIBCH_p.I86V
TTTGACATCACAGCATCTAGCTA	GTGCaCCTGCGGCTGGAGG	CCATGGTGCACCTGCGGCTGGAGGTGGCAG	COMMD4_p.H156R
TTTGACTATCATATATCAGATAT	AGTaCTTCTGAGTTTTTGA	CAGATAGTACTTCTGAGTTTTTGATGGCTG	KIAA1377_p.T1016A
TTTGCTCACAGCATACGTATATA	TATTGaTAGTAGGAGAACC	AAGAATATTGATAGTAGGAGAACCAGGATT	ATAD2_p.I797V
TTTGCGTCATCACTCAGCATACG	ATGaGGTAACACCAAGCTC	ACCCTATGAGGTAACACCAAGCTCTGGGAG	DPH1_p.E367G
TTTGTACATCTCAGCATCGAGAG	TCCaGGAGTGGAAGAGACT	CTGGTTCCAGGAGTGGAAGAGACTAGGAGT	PTPMT1_p.001
TTTGAGTGTCGTCATCGTCAGCA	CCGaGGAGTCCAGAAGAGG	AGAGCCCGAGGAGTCCAGAAGAGGAGGAGC	CCT8L2_p.R24G
TTTGCATGACATCGTCATCTCTA	CCTATaAGTGTGGAAAATG	GAAACCCTATAAGTGTGGAAAATGCGGGAA	ZNF556_p.K316E
TTTGGTATCGCTATCAGCATATC	GGTCaGGAGAAGCAGGGAG	AAGGAGGTCAGGAGAAGCAGGGAGAGGTAA	NASP_p.Q260R
TTTGATCATCGTCAGTCAGTATC	GGTCaGGAGAAGCAGGGAG	AAGGAGGTCAGGAGAAGCAGGGAGAGGTAA	NASP_p.Q260R
TTTGGAGCAGTGTATCATATATC	TTCTaCCCAAAGCCCGTGT	CAGGATTCTACCCAAAGCCCGTGTGGGTGA	CD1B_p.Y230C
TTTGGTCATCTATCATCAGCGAG	CGTGaCAGAAAATTCCTGG	AAGAGCGTGACAGAAAATTCCTGGAGGAGG	TCHH_p.D1484G
TTTGTCATGTCACATACGTCTAC	AAGaTGGCCCACATGGAGA	GTGAGAAGATGGCCCACATGGAGAAGGAGT	BICD1_p.M480V
TTTGAGTCAGATCAGCTATCTAT	GTAGaCCAGAGTATCGAGA	AGGCTGTAGACCAGAGTATCGAGAAGGTGA	SCARB2_p.D34G
TTTGAGACATCATCATAGCTCAC	TGGaCAACGAAATAGACAA	GAATTTGGACAACGAAATAGACAATGGACT	PTX3_p.D31G
TTTGAGTATCATCACGAGTATAC	TGGTCaTGGAATACCTTGC	GTTTGTGGTCATGGAATACCTTGCTGGGGG	PAK2_p.M323V
TTTGCATGACATAGTCATATATC	GATGaGGATGAGGTGGAAG	AGGAAGATGAGGATGAGGTGGAAGAGGAGG	GPIHBP1_p.E43G
TTTGACAGTCAGTAGTCTAGTAG	AGAGGaTGGATGTTGTGTT	TGGTGAGAGGATGGATGTTGTGTTTGGGAA	UBASH3B_p.M395V
TTTGGTCAGTACAGTATATAGCT	ATCaTTCTGGATTTGGACA	GTATAATCATTCTGGATTTGGACAGGGAAG	FAM98A_p.H507R
TTTGATATCAGTATCATCTCGTC	AAGTGaGAGCCAGTGAAGA	ATTTGAAGTGAGAGCCAGTGAAGATGGCAG	SGCZ_p.R156G
TTTGCATATCATATACTCAGTAT	GCGAaCCCACACAGGTAGG	CACCTGCGAACCCACACAGGTAGGGGGACA	KLF4_p.T419A
TTTGTGTGTCAGCATATAGTCTC	AGGaGTGTTCAAAATACGG	GAAGAAGGAGTGTTCAAAATACGGAGGAAA	SLC4A4_p.E629G
TTTGGTAGTCAGTCAGTCAGCTC	CAAaTAAGTCCTGTAAGTG	AGGATCAAATAAGTCCTGTAAGTGAGGTAT	PRR14L_p.I581V
TTTGCTACTCTATCGTCAGCTAG	AATaTAGCCAGAGGAAAAA	TTTTGAATATAGCCAGAGGAAAAAAGGATG	ANKRD36_p.I804V
TTTGGCAGTCAGTCTCGTATAGT	TTGGGaGAGCTAGTCTACA	TTCCATTGGGAGAGCTAGTCTACATGGTGG	NID1_p.R1004G
TTTGCTAGTATCTATATCACTAC	GTGTCaATGGGGAAATTGA	CCTGTGTGTCAATGGGGAAATTGAAGGCCT	ANP32E_p.N31D
TTTGAGTGTCAGTATCAGCACTA	TTGGaGAATTATAATAACT	TGATGTTGGAGAATTATAATAACTTGGTCT	ZNF540_p.E37G
TTTGACGCATCGTAGCATCATCA	GAGTaCAGTGGCACCATCT	GGCTGGAGTACAGTGGCACCATCTTGGCTC	SYT14_p.Y36C
TTTGCGTGTCATCTATCATCTGT	GTCAaGCAATATAAGAGCG	AATTTGTCAAGCAATATAAGAGCGAGGCCC	LMCD1_p.K187R
TTTGTATCATCATCATACTCACG	GAGGaGGATCAGGCATCCC	AGAAAGAGGAGGATCAGGCATCCCAGGGTT	ARHGAP35_p.E1191G
TTTGATCGTCATCACTACATCGC	GATGaGTTAAAAGAAGCTC	CTAAAGATGAGTTAAAAGAAGCTCTGGATG	IDE_p.E699G
TTTGTGTCATCATCACTACAGTC	CTGGCaTAGAAGCCCGGGC	CAAGGCTGGCATAGAAGCCCGGGCGGGCCC	STXBP2_p.I526V
TTTGTATATCTCACAGCAGTCAG	CAAATaTAGGAAGAGGAAC	AAAGCCAAATATAGGAAGAGGAACTGGAAG	BDP1_p.I818V
TTTGACAGACATCATCATCGCGA	GGGCaGCCGCTCAGGGATG	TGCAGGGGCAGCCGCTCAGGGATGGGGAGG	ZSCAN10_p.Q52R
TTTGTCTGTCATCTCGTCATCTC	GATCaAGAACAGGAGGAAG	AGTCAGATCAAGAACAGGAGGAAGAGGTAA	ANK2_p.Q1454R
TTTGCTATCACAGTATCGTCTGT	GGGGGaCGATCTGAGAATG	GAGTTGGGGGACGATCTGAGAATGGGGGAG	MYO18B_p.D367G
TTTGTATATCGTCACTCATATAT	GGTaTCTTGGCTATACTAG	TAAAGGGTATCTTGGCTATACTAGTGGATT	SLC38A1_p.Y217C
TTTGTCAGAGTGATCAGTATCTA	TGGaCCTCCGGGGTGAGTC	GGAGCTGGACCTCCGGGGTGAGTCCGGGGG	SNRPA1_p.D25G
TTTGGAGATCAGTAGCATCGATC	CAGaGAGTGGTGGAAAGCC	TTGTCCAGAGAGTGGTGGAAAGCCTGGATG	COL6A3_p.R1053G
TTTGCATACGCATCATATCTACT	AATTaGAGTACCAGGAAAC	AATGCAATTAGAGTACCAGGAAACAGGAGT	CR1_p.R1601G
TTTGTCGCATCGCATCATCACGT	CCCaGGCCAGCTGGGGAGT	CCGGGCCCAGGCCAGCTGGGGAGTGGGAGG	ZBTB4_p.R208G
TTTGCAGTCATCATGTCTATCTA	GCGGCGTAATGCTTGAAAG	CCAGTGCGGCGTAATGCTTGAAAGAGGGGG	NT_nontargetX
TTTGACAGTGTACTATCATCACG	TCGTTTCCGCTTAACGGCG	GCCAATCGTTTCCGCTTAACGGCGAGGCCA	NT_nontargetX
TTTGTATCAGATCAGTAGCTATA	GCCGGGACCGTTAGGGAAT	GGTCCGCCGGGACCGTTAGGGAATAGGATA	NT_nontargetX
TTTGCAGTCAGAGTCTCTATCGT	TACCATTGCCGGCTCCCTA	GCCAGTACCATTGCCGGCTCCCTAAGGGAC	NT_nontargetX
TTTGTGTATACATCATCATCGCG	CGAACCCCGTAGCCAGGCT	CGAAGCGAACCCCGTAGCCAGGCTAGGATA	NT_nontargetX
TTTGCATCATCTACATCACGTAT	ACGCTTGCGTTTAGCGTCC	CCCGTACGCTTGCGTTTAGCGTCCAGGTCC	NT_nontargetX
TTTGTCGCATATCATCTACGATC	TGTCGGATTCCGCCGCTTA	GGGTGTGTCGGATTCCGCCGCTTAAGGTCA	NT_nontargetX
TTTGGAGTCATCTACATCTAGTA	ACGGCCTAACTTGCTGATA	AGAGCACGGCCTAACTTGCTGATAAGGAAA	NT_nontargetX
TTTGGTCACTGTATCAGCAGTCA	GGTAGTATTAATCGCTGAC	ACACCGGTAGTATTAATCGCTGACAGGCGG	NT_nontargetX
TTTGCTATCTATCAGTCAGTAGC	CTTAACCTATCCGCCAGTA	TGGCGCTTAACCTATCCGCCAGTAAGGCCT	NT_nontargetX
TTTGCGTCATCGTCAGCATGTCT	ATGGCGCTTCAGTCGTCGG	GCTTGATGGCGCTTCAGTCGTCGGAGGCCT	NT_nontargetX
TTTGTACAGCATATATATATCAT	AATCGGCGACGTTTTAAAT	ACGGCAATCGGCGACGTTTTAAATAGGATA	NT_nontargetX
TTTGTGTCTATCACATACTAGTA	TCGACAGTTCGTCCCGAGC	GTCCCTCGACAGTTCGTCCCGAGCAGGGCG	NT_nontargetX
TTTGGACAGATCATATCATAGCT	AGGAGTCGCCGATACGCGT	CTTACAGGAGTCGCCGATACGCGTAGGTCA	NT_nontargetX
TTTGTACAGTATATAGCATCTAT	TAATCCGGAAACGCTCGAC	GGAAATAATCCGGAAACGCTCGACAGGTCT	NT_nontargetX
TTTGTCTATCATGTCAGTATCTA	TCGTCCGGGATTACAAAAT	ACTCGTCGTCCGGGATTACAAAATAGGTGG	NT_nontargetX
TTTGAGAGTCATCGTCAGTACAT	GCGCAGATAGCGCGTATCA	ACGCAGCGCAGATAGCGCGTATCAAGGTGT	NT_nontargetX
TTTGATAGTATCGCTCATAGCAG	AATCGACCGACACTAATGT	GAAGGAATCGACCGACACTAATGTAGGTGT	NT_nontargetX
TTTGCAGAGTCTCATCATCTACT	GCTCCATCGCCGCGATAAT	GCTAAGCTCCATCGCCGCGATAATAGGTCC	NT_nontargetX
TTTGCTCATCATCGTATCAGCTA	AATATCGGGTGCTACAGGA	CTCACAATATCGGGTGCTACAGGAAGGCAA	NT_nontargetX
TTTGAGTGTGTACTCATCTCGTC	ACTAGCCCGAGCAGCTTCG	ATGAAACTAGCCCGAGCAGCTTCGAGGCAC	NT_nontargetX
TTTGTACGTCATCATATAGTATA	TAGACGTCGTGAGCTTCAC	ATAGGTAGACGTCGTGAGCTTCACAGGTGT	NT_nontargetX
TTTGAGTGTAGCATATATATCTA	CCCTCCGAATCGTAACGGA	ATACACCCTCCGAATCGTAACGGAAGGCGA	NT_nontargetX
TTTGTGATCAGTATCAGAGTACG	GGGACGTCGCGAAAATGTA	TAGGCGGGACGTCGCGAAAATGTAAGGCGC	NT_nontargetX
TTTGGTGTATATATCATCTAGTC	GAACTTAATCCCGTGGCAA	CAAACGAACTTAATCCCGTGGCAAAGGGGT	NT_nontargetX
TTTGCTCAGTATAGCATCATGTA	TATCTCGAGTGGTAATGCG	AAAACTATCTCGAGTGGTAATGCGAGGTCA	NT_nontargetX
TTTGTACATCACATATATCGAGT	CCTGGATACCGCGTGGTTA	ATAGTCCTGGATACCGCGTGGTTAAGGGCC	NT_nontargetX
TTTGTAGAGCAGTATATCTACAG	GTCGCCATATGCCGGTGGC	GACACGTCGCCATATGCCGGTGGCAGGGCA	NT_nontargetX
TTTGGTGTATCAGTATCGAGTCA	CGTCGTTTAGCACCCGGCT	TATCACGTCGTTTAGCACCCGGCTAGGCAC	NT_nontargetX
TTTGGTCACTCGTCATCGCAGTA	TAGCCGCCGCTCATTACTT	ATGTATAGCCGCCGCTCATTACTTAGGGTT	NT_nontargetX
TTTGCTAGTCAGATCATATCGCT	GGCCACGAATTCCGCCGCC	TCTCTGGCCACGAATTCCGCCGCCAGGATA	NT_nontargetX
TTTGCGTATCATCGTCAGCAGTC	AAGATCCGCGGGTGGCAAC	TATATAAGATCCGCGGGTGGCAACAGGATC	NT_nontargetX
TTTGCATCATCGCTCGTCTATAT	GCTAGTACGCTCCTCTATA	ATATCGCTAGTACGCTCCTCTATAAGGGTC	NT_nontargetX
TTTGGTAGCATATCTATCATCAG	CTGGCTTGACACGACCGTT	GTCGTCTGGCTTGACACGACCGTTAGGTCA	NT_nontargetX
TTTGTGATATCGTCATCATATAT	CGCTATTGAAACCGCCCAC	CCTCCCGCTATTGAAACCGCCCACAGGTTG	NT_nontargetX
TTTGACTACAGTATCGCTATATA	CGGAGGCTAAGCGTCGCAA	ATGCACGGAGGCTAAGCGTCGCAAAGGGAA	NT_nontargetX
TTTGTCTATCATCAGCACTACGT	GGAGTAACAAGCGGACGGA	ATCACGGAGTAACAAGCGGACGGAAGGCAT	NT_nontargetX
TTTGGAGTAGTCAGTCACTATAT	CGTTGGACTATGGCGGGTC	TTCGCCGTTGGACTATGGCGGGTCAGGAGC	NT_nontargetX
TTTGATGCATCATCATCACGATC	TGGATCGCCCGCAGAAATA	CTTCCTGGATCGCCCGCAGAAATAAGGGAG	NT_nontargetX
TTTGGTCTGTCAGTATATCATAT	CATAGTCGACGGCTCGATT	AGCTACATAGTCGACGGCTCGATTAGGAAT	NT_nontargetX
TTTGTAGTACATCATCGCTCGTA	CAAACCCGAGTGACACGTC	GCCCGCAAACCCGAGTGACACGTCAGGGAT	NT_nontargetX
TTTGCGTCATCATCATCTACAGC	CCCGATAATAGCTACTGGT	TGCTACCCGATAATAGCTACTGGTAGGTAT	NT_nontargetX
TTTGACTATCTATCGCGTCAGTC	TAGCCCTCGATTGGTTGCG	CGTGTTAGCCCTCGATTGGTTGCGAGGGTG	NT_nontargetX
TTTGCTCATCTACTATCATACGA	GGCTCGTTCTACGCACTGA	CCAACGGCTCGTTCTACGCACTGAAGGTTT	NT_nontargetX
TTTGCTCATCTCATCTCATCACT	GAGGATCATGTCGAGCGCC	CGTCTGAGGATCATGTCGAGCGCCAGGATC	NT_nontargetX
TTTGCAGTCACTCAGCATCTATG	AACGCCGCTCAAGTTGATA	GAACGAACGCCGCTCAAGTTGATAAGGCAA	NT_nontargetX
TTTGATATCGTGTATCATCTCAG	CATATCGGGGCGAGACATG	CTCACCATATCGGGGCGAGACATGAGGTTT	NT_nontargetX
TTTGTAGTGTAGCTAGTATATAT	TCAACCGACCGTATGGTCA	GGGCCTCAACCGACCGTATGGTCAAGGACC	NT_nontargetX
TTTGATCATGTCAGCAGTAGTAC	TAAGGCCCGCGTACGAGCT	TCCTGTAAGGCCCGCGTACGAGCTAGGGGC	NT_nontargetX
TTTGCTCAGTATCAGTACAGTAC	GGCCCGCATAGGATATCGC	TAACGGGCCCGCATAGGATATCGCAGGGGT	NT_nontargetX
